Transaction Date,Transaction Type,Transaction Description,Debit Amount,Credit Amount,Balance
25/07/2022,BP,SAVE THE CHANGE,3.11,,541.43
25/07/2022,DEB,LIDL GB  NOTTINGHA,15.02,,544.54
25/07/2022,DEB,NON-GBP PURCH FEE,0.5,,559.56
25/07/2022,DEB,NON-GBP TRANS FEE,0.37,,560.06
25/07/2022,DEB,TRAVELIUM LLC,12.59,,560.43
25/07/2022,DEB,Audible UK,7.99,,573.02
25/07/2022,FPO,MISS D WU,25,,581.01
25/07/2022,DEB,SAINSBURYS S/MKTS,35.57,,606.01
22/07/2022,DEB,LIDL GB  NOTTINGHA,18.21,,641.58
22/07/2022,DEB,Amazon.co.uk*VK6IN,13.51,,659.79
22/07/2022,FPO,MR J DOME,175,,673.3
21/07/2022,FPO,MISS D WU,35,,848.3
20/07/2022,FPO,TRADING212UK,200,,883.3
20/07/2022,FPI,SHEILA SMITH,,390,1083.3
20/07/2022,BP,SAVE THE CHANGE,0.65,,693.3
19/07/2022,DEB,THE TERRACE CAFE M,31.35,,693.95
19/07/2022,BP,SAVE THE CHANGE,1.6,,725.3
18/07/2022,DEB,The Corinthian,7.4,,726.9
18/07/2022,DEB,The Corinthian,4.6,,734.3
18/07/2022,DEB,TIGERMILK EVENTS,4.5,,738.9
18/07/2022,DEB,UBER   *TRIP,11.9,,743.4
18/07/2022,DD,VIRGIN MEDIA PYMTS,56.25,,755.3
18/07/2022,DD,O2,17.95,,811.55
18/07/2022,BP,SAVE THE CHANGE,2.4,,829.5
18/07/2022,CPT,LNK COOPERATIVE PL,40,,831.9
18/07/2022,DEB,COSMIC KITCHEN LIM,75.8,,871.9
18/07/2022,DEB,TESCO STORE 3033,20,,947.7
18/07/2022,DEB,CROWNE PLAZA,10,,967.7
18/07/2022,DEB,EAST MIDS RAILWAY,213,,977.7
18/07/2022,DEB,AMZNMktplace,26.99,,1190.7
18/07/2022,DEB,TESCO STORE 3033,22.1,,1217.69
18/07/2022,DEB,SumUp  *Taxi first,8,,1239.79
15/07/2022,DEB,Amazon.co.uk*ST7ZE,42.01,,1247.79
15/07/2022,DEB,ASPIRE CAFE,2.7,,1289.8
15/07/2022,FPI,WU,,27,1292.5
15/07/2022,BP,SAVE THE CHANGE,1.43,,1265.5
14/07/2022,DEB,UBER   *TRIP,5.66,,1266.93
14/07/2022,DEB,UBER   *TRIP,5.38,,1272.59
14/07/2022,DEB,MEDINA CONTINENTAL,4.53,,1277.97
14/07/2022,BP,SAVE THE CHANGE,1.01,,1282.5
13/07/2022,DEB,HPI INSTANT INK UK,4.49,,1283.51
13/07/2022,DEB,CAFE TERRAZZO,3.5,,1288
13/07/2022,BP,SAVE THE CHANGE,0.08,,1291.5
12/07/2022,FPO,CAPEWELL WINDOW CL,30,,1291.58
12/07/2022,DEB,AMZNMktplace,12.99,,1321.58
12/07/2022,DEB,AMZNMktplace,9.93,,1334.57
12/07/2022,BP,SAVE THE CHANGE,0.28,,1344.5
11/07/2022,DEB,LIDL GB  NOTTINGHA,47.84,,1344.78
11/07/2022,DEB,UBER   *TRIP,4.88,,1392.62
11/07/2022,BP,SAVE THE CHANGE,1.16,,1397.5
11/07/2022,DEB,UBER   *TRIP,9.69,,1398.66
11/07/2022,DEB,UBER   *TRIP,7.48,,1408.35
11/07/2022,DEB,Subway 26377 Corne,6.89,,1415.83
11/07/2022,DEB,UBER   *TRIP,1,,1422.72
08/07/2022,FPI,Zoe Zappa,,325,1423.72
08/07/2022,DEB,DOSA N CHUTNEY,34.78,,1098.72
08/07/2022,BGC,UNIV OF NOTTINGHAM,,351.08,1133.5
07/07/2022,BP,SAVE THE CHANGE,0.77,,782.42
06/07/2022,DEB,Hotel on Booking.c,196.24,,783.19
06/07/2022,DEB,AMZNMktplace,6.99,,979.43
06/07/2022,BP,SAVE THE CHANGE,0.26,,986.42
05/07/2022,DEB,AMZNMktplace,15.99,,986.68
05/07/2022,DEB,AMZNMktplace,2.75,,1002.67
04/07/2022,DEP,CLUB LLOYDS WAIVED,,3,1005.42
04/07/2022,PAY,CLUB LLOYDS FEE,3,,1002.42
04/07/2022,FPI,O CONNOR CAROL,,10,1005.42
04/07/2022,BP,SAVE THE CHANGE,0.63,,995.42
04/07/2022,FPO,PAULINA PIPPEN,280,,996.05
04/07/2022,DEB,AMZNMktplace,27.99,,1276.05
01/07/2022,,INTEREST (GROSS),,0.56,1304.04
01/07/2022,DEB,TROPICAL SUMMER FE,240.38,,1303.48
01/07/2022,DEB,SumUp  *LTP,6,,1543.86
01/07/2022,DD,BARCLAYS UK MTGES,981.71,,1549.86
01/07/2022,DD,NOTTM CITY COUNC,112,,2531.57
01/07/2022,DD,OCTOPUS ENERGY,100,,2643.57
01/07/2022,DD,SEVERN TRENT WATER,43.95,,2743.57
01/07/2022,SO,ESAVINGS ACCOUNT,300,,2787.52
01/07/2022,BP,SAVE THE CHANGE,0.17,,3087.52
01/07/2022,BGC,UNIV OF NOTTINGHAM,,44.32,3087.69
30/06/2022,DEB,LIDL GB  NOTTINGHA,8.83,,3043.37
29/06/2022,DEB,Amazon.co.uk*2Y0SX,229,,3052.2
29/06/2022,FPO,TRADING212UK,1000,,3281.2
29/06/2022,DD,THE GYM LTD,19.99,,4281.2
29/06/2022,BP,SAVE THE CHANGE,0.21,,4301.19
29/06/2022,BGC,UNIV OF NOTTINGHAM,,3748.52,4301.4
28/06/2022,DEB,LIDL GB  NOTTINGHA,6.79,,552.88
28/06/2022,BP,SAVE THE CHANGE,2,,559.67
27/06/2022,CPT,LNK TESCO HK R NOT,50,,561.67
27/06/2022,DEB,LIDL GB NOTTINGHAM,22.09,,611.67
27/06/2022,DEB,POUNDLAND LTD 1718,14.25,,633.76
27/06/2022,DEB,UBER   *TRIP,5.78,,648.01
27/06/2022,DEB,IZ *LTD GROUP LIMI,4.93,,653.79
27/06/2022,DEB,GREGGS PLC,3.95,,658.72
27/06/2022,BP,SAVE THE CHANGE,3.26,,662.67
27/06/2022,DEB,HEAVENLY DESSERTS,11.9,,665.93
27/06/2022,DEB,LIDL GB  NOTTINGHA,13.06,,677.83
24/06/2022,DEB,PIE MINISTER,41.2,,690.89
24/06/2022,DEB,BELL INN,14.09,,732.09
24/06/2022,DEB,CAFE TERRAZZO,3.5,,746.18
24/06/2022,DEB,Audible UK,7.99,,749.68
24/06/2022,DEB,PIE MINISTER,,8.17,757.67
23/06/2022,BP,SAVE THE CHANGE,1.26,,749.5
22/06/2022,DEB,DOMINO'S PIZZA,9.99,,750.76
22/06/2022,DEB,LIDL GB NOTTINGHAM,5.25,,760.75
22/06/2022,DEB,CAFE TERRAZZO,3.5,,766
22/06/2022,BP,SAVE THE CHANGE,1.09,,769.5
21/06/2022,DEB,UBER   *TRIP,6.59,,770.59
21/06/2022,DEB,NON-GBP TRANS FEE,0.06,,777.18
21/06/2022,DEB,ROMA TERMINI SELF,2.32,,777.24
21/06/2022,BP,SAVE THE CHANGE,0.92,,779.56
20/06/2022,DEB,DOSA N CHUTNEY,41.2,,780.48
20/06/2022,FPO,PAULINA PIPPEN,4.52,,821.68
20/06/2022,FPO,MISS D WU,11,,826.2
20/06/2022,FPO,TRADING212UK,200,,837.2
20/06/2022,FPI,SHEILA SMITH,,390,1037.2
20/06/2022,DEB,NON-GBP TRANS FEE,0.44,,647.2
20/06/2022,DEB,CHEF EXPRESS S.P.A,14.88,,647.64
20/06/2022,BP,SAVE THE CHANGE,1.72,,662.52
20/06/2022,DEB,NON-GBP TRANS FEE,0.57,,664.24
20/06/2022,DEB,MS* CASASANTASOFIA,19.27,,664.81
20/06/2022,DEB,NON-GBP TRANS FEE,0.37,,684.08
20/06/2022,DEB,Pizza Forum,12.47,,684.45
20/06/2022,DEB,AMZNMktplace,23,,696.92
20/06/2022,DEB,NON-GBP TRANS FEE,0.46,,719.92
20/06/2022,DEB,BUDDY ITALIAN REST,15.54,,720.38
17/06/2022,DD,VIRGIN MEDIA PYMTS,56.25,,735.92
17/06/2022,BP,SAVE THE CHANGE,1.26,,792.17
16/06/2022,DEB,NON-GBP TRANS FEE,0.76,,793.43
16/06/2022,DEB,UBER   *TRIP,25.57,,794.19
16/06/2022,DEB,NON-GBP TRANS FEE,0.57,,819.76
16/06/2022,DEB,UBER *TRIP HELP.UB,19.17,,820.33
16/06/2022,DD,O2,18.01,,839.5
15/06/2022,BP,SAVE THE CHANGE,0.51,,857.51
14/06/2022,DEB,NON-GBP TRANS FEE,5.11,,858.02
14/06/2022,DEB,POSTE ITALIANE,171,,863.13
14/06/2022,DEB,HPI INSTANT INK UK,4.49,,1034.13
14/06/2022,BP,SAVE THE CHANGE,0.51,,1038.62
13/06/2022,DEB,EAST MIDS RAILWAY,56.7,,1039.13
13/06/2022,DEB,WH SMITH,8.79,,1095.83
13/06/2022,BP,SAVE THE CHANGE,4.3,,1104.62
13/06/2022,DEB,ASIANA HYPERMARKET,60.83,,1108.92
13/06/2022,DEB,LIDL GB NOTTINGHAM,34.12,,1169.75
13/06/2022,DEB,UBER* TRIP,7.01,,1203.87
13/06/2022,CPT,LNK NOTTINGHAM RAI,30,,1210.88
13/06/2022,DEB,UBER   *TRIP,7.51,,1240.88
13/06/2022,DEB,AMZNMktplace,5.55,,1248.39
13/06/2022,FPO,MISS D WU,29,,1253.94
13/06/2022,DEB,DOMINO'S PIZZA - H,,9.99,1282.94
10/06/2022,FPO,MISS D WU,16,,1272.95
10/06/2022,DEB,LIDL GB  NOTTINGHA,11.43,,1288.95
10/06/2022,DEB,CAFE TERRAZZO,2.25,,1300.38
09/06/2022,BP,SAVE THE CHANGE,0.97,,1302.63
08/06/2022,DEB,Subway 32610 Midla,13.78,,1303.6
08/06/2022,DEB,CAFE TERRAZZO,2.25,,1317.38
07/06/2022,BP,SAVE THE CHANGE,2.04,,1319.63
06/06/2022,DEP,CLUB LLOYDS WAIVED,,3,1321.67
06/06/2022,PAY,CLUB LLOYDS FEE,3,,1318.67
06/06/2022,DEB,AMZNMktplace,9.99,,1321.67
06/06/2022,DEB,PRIMARK,38.3,,1331.66
06/06/2022,DEB,BLEND COFFEE HOUSE,18.45,,1369.96
06/06/2022,DEB,Murat food centre,13.81,,1388.41
06/06/2022,DEB,HEAVENLY DESSERTS,4.41,,1402.22
06/06/2022,DEB,BLEND COFFEE HOUSE,,3.25,1406.63
06/06/2022,BP,SAVE THE CHANGE,2.76,,1403.38
06/06/2022,DEB,WHITE ROSE TRADING,29.05,,1406.14
06/06/2022,DEB,PIE MINISTER,23,,1435.19
06/06/2022,DEB,CINEWORLD NOT CP,19.98,,1458.19
06/06/2022,DEB,LIDL GB NOTTINGHAM,16.37,,1478.17
06/06/2022,DEB,CLOUD9 PURSUITS LT,10,,1494.54
06/06/2022,DEB,DOMINO'S PIZZA,9.99,,1504.54
06/06/2022,DEB,DOMINO'S PIZZA,9.99,,1514.53
06/06/2022,DEB,DOMINO'S PIZZA,9.99,,1524.52
06/06/2022,DEB,Amazon.co.uk*2G6K0,6.98,,1534.51
06/06/2022,DEB,DOMINO'S PIZZA,1.64,,1541.49
06/06/2022,DEB,LIDL GB  NOTTINGHA,9,,1543.13
01/06/2022,,INTEREST (GROSS),,0.56,1552.13
01/06/2022,DEB,CAFE TERRAZZO,4.25,,1551.57
01/06/2022,DD,BARCLAYS UK MTGES,981.71,,1555.82
01/06/2022,DD,NOTTM CITY COUNC,112,,2537.53
01/06/2022,DD,OCTOPUS ENERGY,100,,2649.53
01/06/2022,DD,SEVERN TRENT WATER,43.97,,2749.53
01/06/2022,SO,ESAVINGS ACCOUNT,300,,2793.5
31/05/2022,BP,SAVE THE CHANGE,1.71,,3093.5
30/05/2022,DEB,13th Element,35.5,,3095.21
30/05/2022,DEB,ORIENTAL MART HYDR,16.49,,3130.71
30/05/2022,DEB,IZ *WHITE ROSE TRA,12,,3147.2
30/05/2022,DEB,THE GYM LIMITED,10,,3159.2
30/05/2022,DEB,HUI LAU SHAN,9.8,,3169.2
30/05/2022,DEB,POUNDLAND LTD 1718,1.5,,3179
30/05/2022,FPO,TRADING212UK,1100,,3180.5
30/05/2022,BP,SAVE THE CHANGE,1.89,,4280.5
30/05/2022,BGC,UNIV OF NOTTINGHAM,,3748.92,4282.39
30/05/2022,FPO,MISS D WU,26,,533.47
30/05/2022,DEB,BACHATA SUENO,24,,559.47
30/05/2022,DEB,LIDL GB  NOTTINGHA,11.58,,583.47
30/05/2022,DEB,Amazon.co.uk*2G8AO,5.99,,595.05
27/05/2022,DEB,AMZNMktplace,55.58,,601.04
27/05/2022,DEB,LIDL GB NOTTINGHAM,31.9,,656.62
27/05/2022,DEB,UBER   *TRIP,5.06,,688.52
27/05/2022,BP,SAVE THE CHANGE,1.03,,693.58
26/05/2022,CPT,LNK TESCO NO RA RD,50,,694.61
26/05/2022,DEB,LIDL GB  NOTTINGHA,6.47,,744.61
26/05/2022,DEB,CAFE TERRAZZO,2.5,,751.08
26/05/2022,BP,SAVE THE CHANGE,0.53,,753.58
25/05/2022,DEB,LIDL GB NOTTINGHAM,16.83,,754.11
25/05/2022,DEB,AMZNMktplace,6.99,,770.94
25/05/2022,DEB,CAFE TERRAZZO,2.65,,777.93
25/05/2022,FPO,TRADING212UK,200,,780.58
25/05/2022,FPI,PAULINA PIPPEN,,325,980.58
25/05/2022,BP,SAVE THE CHANGE,0.71,,655.58
24/05/2022,DEB,LIDL GB  NOTTINGHA,5.3,,656.29
24/05/2022,DEB,Audible UK,7.99,,661.59
24/05/2022,BP,SAVE THE CHANGE,0.31,,669.58
23/05/2022,DEB,POUNDLAND LTD 1726,16,,669.89
23/05/2022,DEB,TESCO STORE 2960,15.69,,685.89
23/05/2022,DEB,ALADDINS BIKES,120,,701.58
23/05/2022,BP,SAVE THE CHANGE,1.37,,821.58
23/05/2022,DEB,IZ *WHITE ROSE TRA,12.5,,822.95
23/05/2022,DEB,TESCO STORES 6430,2.75,,835.45
23/05/2022,CPT,LNK SAINSBURYS BAN,40,,838.2
20/05/2022,FPO,MISS D WU,15,,878.2
20/05/2022,DEB,Kaya Food Centre,6.38,,893.2
20/05/2022,DEB,ALADDINS BIKES,22,,899.58
20/05/2022,FPO,MISS D WU,22,,921.58
20/05/2022,FPO,TRADING212UK,300,,943.58
20/05/2022,FPI,SHEILA SMITH,,380,1243.58
20/05/2022,BP,SAVE THE CHANGE,1.36,,863.58
19/05/2022,DEB,AMZNMktplace,33.02,,864.94
19/05/2022,DEB,Amazon.co.uk*255RJ,14.99,,897.96
19/05/2022,DEB,LIDL GB  NOTTINGHA,4.63,,912.95
19/05/2022,BP,SAVE THE CHANGE,1.32,,917.58
18/05/2022,DEB,ORIENTAL MART HYDR,26.16,,918.9
18/05/2022,DEB,IZ *WHITE ROSE TRA,10,,945.06
18/05/2022,DEB,AMZNMktplace,2.87,,955.06
18/05/2022,DEB,CAFE TERRAZZO,2.65,,957.93
18/05/2022,BP,SAVE THE CHANGE,0.85,,960.58
17/05/2022,DEB,Amazon.co.uk*257UG,12.15,,961.43
17/05/2022,DD,VIRGIN MEDIA PYMTS,25.5,,973.58
17/05/2022,BP,SAVE THE CHANGE,0.98,,999.08
16/05/2022,DEB,NATIONAL MERCH,30,,1000.06
16/05/2022,DEB,HEAVENLY DESSERTS,11.34,,1030.06
16/05/2022,DEB,HEAVENLY DESSERTS,4.68,,1041.4
16/05/2022,DD,O2,17.95,,1046.08
16/05/2022,BP,SAVE THE CHANGE,3.17,,1064.03
16/05/2022,DEB,SAINSBURYS S/MKTS,35.8,,1067.2
16/05/2022,DEB,DOSA N CHUTNEY,32.2,,1103
16/05/2022,DEB,Amazon.co.uk*259S0,7.99,,1135.2
16/05/2022,DEB,LIDL GB  NOTTINGHA,15.84,,1143.19
16/05/2022,DEB,Amazon.co.uk*255B9,10.99,,1159.03
16/05/2022,DEB,ALADDINS BIKES,6,,1170.02
13/05/2022,DEB,HPI INSTANT INK UK,4.49,,1176.02
13/05/2022,DEB,Subway 32610 Midla,11.48,,1180.51
13/05/2022,DEB,LIDL GB NOTTINGHAM,7.54,,1191.99
13/05/2022,DEB,DERBY MED CAFE,3.5,,1199.53
13/05/2022,FPO,TRADING212UK,500,,1203.03
13/05/2022,TFR,R LAWRENCE,,300,1703.03
12/05/2022,BP,SAVE THE CHANGE,0.5,,1403.03
12/05/2022,BGC,NCC TRADE CRED NEW,,150,1403.53
11/05/2022,DEB,UBER   *TRIP,4,,1253.53
11/05/2022,DEB,DERBY MED CAFE,3.5,,1257.53
11/05/2022,BP,SAVE THE CHANGE,0.59,,1261.03
10/05/2022,FPO,MISS D WU,13,,1261.62
10/05/2022,DEB,RAJAH FOOD STORE L,20.41,,1274.62
09/05/2022,BP,SAVE THE CHANGE,2.25,,1295.03
09/05/2022,DEB,MASALA JUNCTION,47.98,,1297.28
09/05/2022,DEB,LIDL GB  NOTTINGHA,14.01,,1345.26
09/05/2022,DEB,LIDL GB  NOTTINGHA,5.85,,1359.27
09/05/2022,FPI,SHEILA SMITH,,50,1365.12
06/05/2022,DEB,HEAVENLY DESSERTS,10.26,,1315.12
06/05/2022,DEB,CAFE TERRAZZO,6,,1325.38
06/05/2022,DEB,CAFE TERRAZZO,2.65,,1331.38
06/05/2022,BP,SAVE THE CHANGE,1.46,,1334.03
05/05/2022,DEB,AMZN Mktp US*1363Y,22.7,,1335.49
05/05/2022,DEB,AMZNMktplace,43.77,,1358.19
05/05/2022,DEB,LIDL GB  NOTTINGHA,8.57,,1401.96
05/05/2022,DEB,DERBY MED CAFE,3.5,,1410.53
05/05/2022,DD,OCTOPUS ENERGY,100,,1414.03
04/05/2022,DEP,CLUB LLOYDS WAIVED,,3,1514.03
04/05/2022,PAY,CLUB LLOYDS FEE,3,,1511.03
04/05/2022,DD,NOTTM CITY COUNC,112,,1514.03
04/05/2022,BP,SAVE THE CHANGE,0.42,,1626.03
03/05/2022,,INTEREST (GROSS),,0.57,1626.45
03/05/2022,FPO,MISS D WU,23,,1625.88
03/05/2022,DEB,LIDL GB  NOTTINGHA,12.58,,1648.88
03/05/2022,FPO,MISS D WU,21,,1661.46
03/05/2022,TFR,R LAWRENCE,,230.66,1682.46
03/05/2022,DD,BARCLAYS UK MTGES,981.71,,1451.8
03/05/2022,DD,SEVERN TRENT WATER,41.89,,2433.51
03/05/2022,SO,ESAVINGS ACCOUNT,300,,2475.4
03/05/2022,BP,SAVE THE CHANGE,3.99,,2775.4
03/05/2022,DEB,ALDI,37.27,,2779.39
03/05/2022,DEB,AMZNMktplace,28.65,,2816.66
03/05/2022,DEB,ORIENTAL MART HYDR,12.8,,2845.31
03/05/2022,DEB,STARBUCKS,8.3,,2858.11
03/05/2022,DEB,KFC NOTTINGHAM,1.49,,2866.41
03/05/2022,DEB,SQ *NOTTINGHAM BAC,10,,2867.9
03/05/2022,DEB,CONFETTI CONSTELLA,5.5,,2877.9
03/05/2022,DEB,CONFETTI CONSTELLA,3.5,,2883.4
29/04/2022,DEB,DERBY MED CAFE,3.5,,2886.9
28/04/2022,FPO,TRADING212UK,1100,,2890.4
28/04/2022,BP,SAVE THE CHANGE,2.44,,3990.4
28/04/2022,BGC,UNIV OF NOTTINGHAM,,3748.93,3992.84
27/04/2022,DEB,Amazon.co.uk*2P60A,18.02,,243.91
27/04/2022,DEB,DOSA N CHUTNEY,13.4,,261.93
27/04/2022,DEB,LIDL GB NOTTINGHAM,8.65,,275.33
27/04/2022,DEB,AMZNMktplace,4.99,,283.98
27/04/2022,DEB,DERBY MED CAFE,3.5,,288.97
27/04/2022,BP,SAVE THE CHANGE,0.99,,292.47
26/04/2022,DEB,AMZNMktplace,41.01,,293.46
26/04/2022,BP,SAVE THE CHANGE,0.7,,334.47
25/04/2022,DEB,DOSA N CHUTNEY,14.8,,335.17
25/04/2022,DEB,TESCO STORES 5653,10.5,,349.97
25/04/2022,BP,SAVE THE CHANGE,2.74,,360.47
25/04/2022,DEB,WORTH THE WEIGHT L,27,,363.21
25/04/2022,DEB,HEAVENLY DESSERTS,15.35,,390.21
25/04/2022,DEB,Audible UK,7.99,,405.56
25/04/2022,FPO,MISS D WU,13,,413.55
25/04/2022,DEB,TESCO STORE 2960,31.82,,426.55
25/04/2022,DEB,ORIENTAL MART HYDR,16.69,,458.37
25/04/2022,CPT,LNK TESCO LONG ROW,40,,475.06
25/04/2022,FPO,TAMBA TAM,13,,515.06
22/04/2022,DEB,AMZNMktplace,22.89,,528.06
22/04/2022,DEB,Amazon.co.uk*2P3K6,20.24,,550.95
22/04/2022,DEB,LIDL GB  NOTTINGHA,11.28,,571.19
21/04/2022,FPO,TRADING212UK,200,,582.47
21/04/2022,FPI,PAULINA PIPPEN,,320,782.47
21/04/2022,BP,SAVE THE CHANGE,0.34,,462.47
20/04/2022,DEB,CINEWORLD NOT CP,19.98,,462.81
20/04/2022,DEB,HEAVENLY DESSERTS,4.68,,482.79
20/04/2022,FPO,TRADING212UK,206.96,,487.47
20/04/2022,FPI,SHEILA SMITH,,380,694.43
20/04/2022,DD,O2,17.95,,314.43
20/04/2022,BP,SAVE THE CHANGE,2.24,,332.38
19/04/2022,DEB,J D SPORTS PLC,85,,334.62
19/04/2022,DEB,LAS IGUANAS,35.06,,419.62
19/04/2022,DEB,AMZNMktplace,23.95,,454.68
19/04/2022,DEB,Elenas Patisserie,15.25,,478.63
19/04/2022,DEB,TESCO STORES 5653,11.5,,493.88
19/04/2022,DD,VIRGIN MEDIA PYMTS,25.5,,505.38
19/04/2022,BP,SAVE THE CHANGE,2.85,,530.88
19/04/2022,DEB,THE NED LUDD,6.95,,533.73
19/04/2022,DEB,HEAVENLY DESSERTS,6.39,,540.68
19/04/2022,DEB,AMZNMktplace,46.99,,547.07
19/04/2022,DEB,LIDL GB  NOTTINGHA,23.79,,594.06
19/04/2022,DEB,GetYourGuide UK Lt,,4.5,617.85
19/04/2022,DEB,SUTTON COLDFIELD A,8.4,,613.35
19/04/2022,DEB,SUTTON COLDFIELD A,5.3,,621.75
19/04/2022,DEB,IZ *WHITE ROSE TRA,11.85,,627.05
19/04/2022,DEB,AMZNMktplace,9.99,,638.9
14/04/2022,DEB,HPI INSTANT INK UK,4.49,,648.89
14/04/2022,CPT,LNK SAINSBURYS BAN,40,,653.38
14/04/2022,BP,SAVE THE CHANGE,0.88,,693.38
13/04/2022,DEB,LIDL GB NOTTINGHAM,66.13,,694.26
13/04/2022,DEB,UBER   *TRIP,4.99,,760.39
13/04/2022,BP,SAVE THE CHANGE,0.01,,765.38
12/04/2022,DEB,AMZNMktplace,9.99,,765.39
12/04/2022,BP,SAVE THE CHANGE,0.1,,775.38
11/04/2022,DEB,AMZNMktplace,16.97,,775.48
11/04/2022,DEB,UBER   *TRIP,6.93,,792.45
11/04/2022,BP,SAVE THE CHANGE,4.88,,799.38
11/04/2022,DEB,STARBUCKS,13.1,,804.26
11/04/2022,DEB,KELLYS CELLARS,7.8,,817.36
11/04/2022,DEB,ARRIVA MERSEYSIDE,4.6,,825.16
11/04/2022,DEB,STARBUCKS,3.75,,829.76
11/04/2022,CPT,LNK TESCO M M WA N,40,,833.51
11/04/2022,DEB,JUMON,56.1,,873.51
11/04/2022,DEB,UBER   *TRIP,7.07,,929.61
08/04/2022,DEB,DARCYS RESTAURANT,39.5,,936.68
08/04/2022,DEB,THE GIANTS BARN CA,5.2,,976.18
08/04/2022,BP,SAVE THE CHANGE,1.81,,981.38
07/04/2022,FPO,MISS D WU,40,,983.19
07/04/2022,DEB,AZZURRI RESTAURANT,24.9,,1023.19
07/04/2022,DEB,Subway 69392 Belfa,9.98,,1048.09
07/04/2022,DEB,LIDL NI LTD,7.29,,1058.07
07/04/2022,DEB,UBER   *TRIP,6.02,,1065.36
07/04/2022,BP,SAVE THE CHANGE,2,,1071.38
06/04/2022,DEB,GetYourGuide UK Lt,43,,1073.38
06/04/2022,DEB,GetYourGuide UK Lt,36,,1116.38
06/04/2022,DEB,LIDL NI LTD,37.09,,1152.38
06/04/2022,DEB,VISIT BELFAST,23,,1189.47
06/04/2022,DEB,BURGER KING,18.68,,1212.47
06/04/2022,DEB,LITTLE WING PIZZER,15.8,,1231.15
06/04/2022,DEB,UBER   *TRIP,6.83,,1246.95
06/04/2022,DEB,ARRIVA MERSEYSIDE,4.6,,1253.78
06/04/2022,BP,SAVE THE CHANGE,1.38,,1258.38
05/04/2022,DEB,LIDL GB  NOTTINGHA,16.13,,1259.76
05/04/2022,DEB,UBER   *TRIP,6.49,,1275.89
05/04/2022,BP,SAVE THE CHANGE,0.98,,1282.38
04/04/2022,DEP,CLUB LLOYDS WAIVED,,3,1283.36
04/04/2022,PAY,CLUB LLOYDS FEE,3,,1280.36
04/04/2022,DEB,ZTL*White Rose Tra,18,,1283.36
04/04/2022,DEB,SLIM CHICKENS NOTT,8,,1301.36
04/04/2022,DEB,HEAVENLY DESSERTS,7.02,,1309.36
04/04/2022,CPT,LNK TESCO HK R NOT,40,,1316.38
04/04/2022,BP,SAVE THE CHANGE,2.12,,1356.38
04/04/2022,DEB,200 DEGREES,10.2,,1358.5
04/04/2022,DEB,THE BREWHOUSE ART,4,,1368.7
04/04/2022,DEB,EASTMIDLANDSCOM,50,,1372.7
04/04/2022,DEB,LIDL GB  NOTTINGHA,13.34,,1422.7
04/04/2022,DEB,ATRIUM JUBILEE 1,4.45,,1436.04
04/04/2022,FPO,MISS D WU,44,,1440.49
04/04/2022,TFR,R LAWRENCE  02APR22,,126,1484.49
04/04/2022,FPO,MISS D WU,34,,1358.49
01/04/2022,,INTEREST (GROSS),,0.49,1392.49
01/04/2022,DEB,Subway 32610 Midla,6.89,,1392
01/04/2022,FPO,MISS D WU,20,,1398.89
01/04/2022,DD,BARCLAYS UK MTGES,981.71,,1418.89
01/04/2022,DD,NOTTM CITY COUNC,106.25,,2400.6
01/04/2022,DD,OCTOPUS ENERGY,90,,2506.85
01/04/2022,DD,SEVERN TRENT WATER,41.89,,2596.85
01/04/2022,SO,ESAVINGS ACCOUNT,300,,2638.74
01/04/2022,BP,SAVE THE CHANGE,1.27,,2938.74
31/03/2022,DEB,DELIVEROO,10.48,,2940.01
31/03/2022,DEB,ATRIUM JUBILEE 1,4.25,,2950.49
31/03/2022,FPO,TRADING212UK,1000,,2954.74
31/03/2022,BP,SAVE THE CHANGE,1.31,,3954.74
30/03/2022,DEB,STARBUCKS,11.85,,3956.05
30/03/2022,DEB,Subway 32610 Midla,6.19,,3967.9
30/03/2022,DEB,ATRIUM JUBILEE 1,2.65,,3974.09
30/03/2022,BGC,UNIV OF NOTTINGHAM,,3801.43,3976.74
29/03/2022,BP,SAVE THE CHANGE,0.45,,175.31
28/03/2022,DEB,UBER   *TRIP,6.55,,175.76
28/03/2022,BP,SAVE THE CHANGE,4.38,,182.31
28/03/2022,DEB,LIDL GB NOTTINGHAM,47.83,,186.69
28/03/2022,DEB,ORIENTAL MART HYDR,20.28,,234.52
28/03/2022,DEB,POUNDLAND LTD 1726,13,,254.8
28/03/2022,DEB,AMZNMktplace,5.99,,267.8
28/03/2022,FPO,MISS D WU,20,,273.79
28/03/2022,FPO,TAMBA TAM,10,,293.79
28/03/2022,DEB,KFC NOTTINGHAM,1.49,,303.79
28/03/2022,DEB,SQ *NOTTINGHAM BAC,12,,305.28
28/03/2022,DEB,CONFETTI CONSTELLA,7.1,,317.28
28/03/2022,DEB,CONFETTI CONSTELLA,6.2,,324.38
25/03/2022,DEB,AIRBNB * HMREJB2DY,376.55,,330.58
25/03/2022,DEB,Subway 32610 Midla,10.18,,707.13
25/03/2022,FPO,TRADING212UK,200,,717.31
25/03/2022,DD,TALKTALK LIMITED,29.95,,917.31
25/03/2022,BP,SAVE THE CHANGE,0.1,,947.26
24/03/2022,DEB,EASYJET   000K38,327.92,,947.36
24/03/2022,DEB,AMZNMktplace,9.99,,1275.28
24/03/2022,DEB,Audible UK,7.99,,1285.27
24/03/2022,FPI,PAULINA PIPPEN,,320,1293.26
24/03/2022,BP,SAVE THE CHANGE,0.89,,973.26
23/03/2022,TFR,R LAWRENCE,,300,974.15
23/03/2022,DEB,AMZNMktplace,6.49,,674.15
23/03/2022,DEB,ATRIUM JUBILEE 1,2.65,,680.64
23/03/2022,DEB,LIDL GB NOTTINGHAM,1.97,,683.29
23/03/2022,BP,SAVE THE CHANGE,0.5,,685.26
23/03/2022,BGC,GOOGLE IRELAND,,63.27,685.76
22/03/2022,FPO,TRADING212UK,200,,622.49
22/03/2022,FPI,SHEILA SMITH,,380,822.49
22/03/2022,CPT,LNK TESCO NO RA RD,40,,442.49
22/03/2022,DEB,PRIMARK,13.5,,482.49
22/03/2022,BP,SAVE THE CHANGE,1.5,,495.99
21/03/2022,DEB,TESCO STORES 6430,7.55,,497.49
21/03/2022,DEB,STARBUCKS,6.45,,505.04
21/03/2022,DEB,SPORTSDIRECT 195,4.5,,511.49
21/03/2022,BP,SAVE THE CHANGE,2.54,,515.99
21/03/2022,DEB,LIDL GB  NOTTINGHA,28.13,,518.53
21/03/2022,FPO,MISS D WU,30,,546.66
18/03/2022,DEB,HPI INSTANT INK UK,4.49,,576.66
18/03/2022,DEB,SUMUP  *LTP,15,,581.15
18/03/2022,DEB,Subway 32610 Midla,6.19,,596.15
18/03/2022,DEB,ATRIUM JUBILEE 1,2.65,,602.34
17/03/2022,DD,VIRGIN MEDIA PYMTS,25.5,,604.99
17/03/2022,BP,SAVE THE CHANGE,1.85,,630.49
16/03/2022,DEB,LIDL GB NOTTINGHAM,16.1,,632.34
16/03/2022,DEB,ATRIUM JUBILEE 1,13.5,,648.44
16/03/2022,DEB,Amazon.co.uk*2159U,5.84,,661.94
16/03/2022,DEB,UBER   *TRIP,4.71,,667.78
16/03/2022,FPO,MISS D WU,6.35,,672.49
16/03/2022,DD,O2,17.31,,678.84
15/03/2022,BP,SAVE THE CHANGE,2,,696.15
14/03/2022,FPO,TAMBA TAM,7,,698.15
14/03/2022,DEB,LIDL GB NOTTINGHAM,53.54,,705.15
14/03/2022,DEB,UBER   *TRIP,5.33,,758.69
14/03/2022,DEB,UBER   *TRIP,19.33,,764.02
14/03/2022,DEB,UBER   *TRIP,17.8,,783.35
14/03/2022,BP,SAVE THE CHANGE,2.15,,801.15
14/03/2022,DEB,RAMSDALE PARK GC,13,,803.3
14/03/2022,DEB,RAMSDALE PARK GC,13,,816.3
14/03/2022,DEB,Subway 30392 Lento,8.58,,829.3
14/03/2022,DEB,RAMSDALE PARK GC,7.85,,837.88
14/03/2022,CPT,LNK COOPERATIVE LE,50,,845.73
14/03/2022,DEB,Subway 26377 Corne,7.28,,895.73
11/03/2022,DEB,SUMUP  *LTP,15,,903.01
11/03/2022,DEB,Subway 32610 Midla,6.89,,918.01
11/03/2022,DEB,ATRIUM JUBILEE 1,4.25,,924.9
10/03/2022,FPO,TAMBA TAM,10,,929.15
10/03/2022,BP,SAVE THE CHANGE,0.76,,939.15
09/03/2022,DEB,Amazon Prime*2X250,79,,939.91
09/03/2022,DEB,Amazon.co.uk*2X7YI,13.99,,1018.91
09/03/2022,DEB,Amazon.co.uk*2X6A1,6,,1032.9
09/03/2022,DEB,ATRIUM JUBILEE 1,4.25,,1038.9
09/03/2022,BP,SAVE THE CHANGE,0.26,,1043.15
08/03/2022,DEB,LIDL GB  NOTTINGHA,20.76,,1043.41
08/03/2022,DEB,AMZNMktplace,14.99,,1064.17
08/03/2022,DEB,AMZNMktplace,9.99,,1079.16
08/03/2022,BP,SAVE THE CHANGE,0.12,,1089.15
07/03/2022,DEB,CINEWORLD,32.88,,1089.27
07/03/2022,BP,SAVE THE CHANGE,4.52,,1122.15
07/03/2022,DEB,ORIENTAL MART HYDR,54.52,,1126.67
07/03/2022,DEB,LIDL GB NOTTINGHAM,48.3,,1181.19
07/03/2022,DEB,Tasnack,25.7,,1229.49
07/03/2022,DEB,NOTTINGHAM WATCH R,10,,1255.19
07/03/2022,DEB,UBER* TRIP,5.16,,1265.19
07/03/2022,DEB,HEAVENLY DESSERTS,6.2,,1270.35
07/03/2022,CPT,LOYD LOYD LOWER PA,40,,1276.55
04/03/2022,DEB,SUMUP  *LTP,24,,1316.55
04/03/2022,DEB,Subway 32610 Midla,6.89,,1340.55
04/03/2022,DEB,ATRIUM JUBILEE 1,4.25,,1347.44
04/03/2022,DEB,LIDL GB NOTTINGHAM,2.46,,1351.69
04/03/2022,BP,SAVE THE CHANGE,0.75,,1354.15
03/03/2022,DEB,Amazon.co.uk*2X4DF,7,,1354.9
03/03/2022,DEB,ATRIUM JUBILEE 1,4.25,,1361.9
03/03/2022,BP,SAVE THE CHANGE,0.86,,1366.15
02/03/2022,DEP,CLUB LLOYDS WAIVED,,3,1367.01
02/03/2022,PAY,CLUB LLOYDS FEE,3,,1364.01
02/03/2022,DEB,TESCO STORES 5653,16.6,,1367.01
02/03/2022,DEB,Subway 32610 Midla,6.89,,1383.61
02/03/2022,DEB,ATRIUM JUBILEE 1,2.65,,1390.5
02/03/2022,TFR,R LAWRENCE,,27.69,1393.15
02/03/2022,FPO,TAMBA TAM,7,,1365.46
02/03/2022,FPO,MISS D WU,10,,1372.46
02/03/2022,BP,SAVE THE CHANGE,0.95,,1382.46
01/03/2022,,INTEREST (GROSS),,0.47,1383.41
01/03/2022,DEB,SAINSBURYS S/MKTS,33.05,,1382.94
01/03/2022,DD,BARCLAYS UK MTGES,981.71,,1415.99
01/03/2022,DD,NOTTM CITY COUNC,157,,2397.7
01/03/2022,DD,OCTOPUS ENERGY,90,,2554.7
01/03/2022,DD,SEVERN TRENT WATER,41.89,,2644.7
01/03/2022,SO,ESAVINGS ACCOUNT,300,,2686.59
01/03/2022,BP,SAVE THE CHANGE,1.08,,2986.59
28/02/2022,DEB,UBER   *TRIP,7.11,,2987.67
28/02/2022,DEB,UBER   *TRIP,6.81,,2994.78
28/02/2022,BP,SAVE THE CHANGE,2.47,,3001.59
28/02/2022,DEB,BURGER KING,13.57,,3004.06
28/02/2022,DEB,LIDL GB  NOTTINGHA,10.11,,3017.63
28/02/2022,DEB,SQ *NOTTINGHAM BAC,12,,3027.74
28/02/2022,DEB,CONFETTI CONSTELLA,8.2,,3039.74
28/02/2022,FPO,MISS D WU,5.1,,3047.94
28/02/2022,FPO,MISS D WU,11,,3053.04
25/02/2022,DEB,SUMUP  *LTP,30,,3064.04
25/02/2022,DEB,ATRIUM JUBILEE 1,2.65,,3094.04
25/02/2022,FPO,TRADING212UK,200,,3096.69
25/02/2022,FPO,TRADING212UK,1000,,3296.69
25/02/2022,FPI,PAULINA PIPPEN,,317,4296.69
25/02/2022,DD,TALKTALK LIMITED,29.95,,3979.69
25/02/2022,BP,SAVE THE CHANGE,0.01,,4009.64
25/02/2022,BGC,UNIV OF NOTTINGHAM,,3801.83,4009.65
24/02/2022,FPO,MISS D WU,10,,207.82
24/02/2022,DEB,Audible UK,7.99,,217.82
24/02/2022,FPO,TAMBA TAM,10,,225.81
24/02/2022,FPO,MISS D WU,5.6,,235.81
24/02/2022,BP,SAVE THE CHANGE,1.15,,241.41
23/02/2022,DEB,UBER   *TRIP,13.31,,242.56
23/02/2022,DEB,Subway 32610 Midla,10.88,,255.87
23/02/2022,DEB,ATRIUM JUBILEE 1,9.75,,266.75
23/02/2022,DEB,UBER* TRIP,7.91,,276.5
23/02/2022,FPO,TRADING212UK,200,,284.41
23/02/2022,BP,SAVE THE CHANGE,0.51,,484.41
22/02/2022,DEB,ORIENTAL MART HYDR,17.51,,484.92
22/02/2022,DEB,T K MAXX,5.98,,502.43
22/02/2022,BP,SAVE THE CHANGE,1.26,,508.41
21/02/2022,DEB,TESCO STORE 2960,35.54,,509.67
21/02/2022,DEB,HEAVENLY DESSERTS,7.2,,545.21
21/02/2022,BP,SAVE THE CHANGE,2.11,,552.41
21/02/2022,DEB,AMZNMktplace,9.99,,554.52
21/02/2022,DEB,SAINSBURY S S/MKTS,1.69,,564.51
21/02/2022,FPI,SHEILA SMITH,,380,566.2
21/02/2022,DEB,LIDL GB  NOTTINGHA,19.65,,186.2
21/02/2022,FPO,MISS D WU,36.5,,205.85
21/02/2022,FPO,MISS D WU,10,,242.35
18/02/2022,DEB,AMZNMktplace,42.43,,252.35
18/02/2022,DEB,SUMUP  *LTP,15,,294.78
18/02/2022,DEB,Subway 32610 Midla,6.89,,309.78
18/02/2022,DEB,ATRIUM JUBILEE 1,2.65,,316.67
18/02/2022,DEB,JUBILEE SPAR,1.59,,319.32
18/02/2022,CPT,LNK TESCO HK R NOT,30,,320.91
17/02/2022,DD,VIRGIN MEDIA PYMTS,25.5,,350.91
17/02/2022,BP,SAVE THE CHANGE,1.56,,376.41
16/02/2022,DEB,Subway 32610 Midla,6.19,,377.97
16/02/2022,DEB,ATRIUM JUBILEE 1,4.25,,384.16
16/02/2022,DD,O2,16.66,,388.41
16/02/2022,BP,SAVE THE CHANGE,1.6,,405.07
15/02/2022,DEB,THE CALCUTTA CLUB,93.85,,406.67
15/02/2022,DEB,LIDL GB  NOTTINGHA,7.31,,500.52
15/02/2022,DEB,HPI INSTANT INK UK,3.49,,507.83
15/02/2022,DEB,HEAVENLY DESSERTS,20.75,,511.32
15/02/2022,DEB,THE CALCUTTA CLUB,,9.05,532.07
15/02/2022,BP,SAVE THE CHANGE,1.73,,523.02
14/02/2022,DEB,CINEWORLD NOT CP,17.98,,524.75
14/02/2022,DEB,Subway 26377 Corne,11.68,,542.73
14/02/2022,DEB,TESCO STORES 5954,4.05,,554.41
14/02/2022,DEB,UBER   *TRIP,5.56,,558.46
14/02/2022,BP,SAVE THE CHANGE,3.03,,564.02
14/02/2022,DEB,Kiehls since 1851,39.6,,567.05
14/02/2022,DEB,LIDL GB NOTTINGHAM,35.04,,606.65
14/02/2022,DEB,LIDL GB NOTTINGHAM,31.26,,641.69
14/02/2022,DEB,The Body Shop,12.75,,672.95
14/02/2022,DEB,AMZNMktplace,14.32,,685.7
14/02/2022,DEB,SUMUP  *HAVANA SAL,10,,700.02
14/02/2022,FPO,MISS D WU,7,,710.02
11/02/2022,FPO,MISS D WU,10,,717.02
11/02/2022,BP,SAVE THE CHANGE,0.94,,727.02
10/02/2022,DEB,LIDL GB  NOTTINGHA,20.06,,727.96
10/02/2022,BP,SAVE THE CHANGE,0.73,,748.02
09/02/2022,DEB,AMZNMktplace,47.68,,748.75
09/02/2022,DEB,AMZNMktplace,33.59,,796.43
09/02/2022,BP,SAVE THE CHANGE,0.35,,830.02
08/02/2022,DEB,PRET A MANGER,30.65,,830.37
08/02/2022,BP,SAVE THE CHANGE,4.02,,861.02
07/02/2022,DEB,EAST MIDS RAILWAY,66.5,,865.04
07/02/2022,DEB,UBER   *TRIP,18.3,,931.54
07/02/2022,DEB,GREGGS,10.2,,949.84
07/02/2022,DEB,UBER   *TRIP,8.83,,960.04
07/02/2022,DEB,UBER   *TRIP,8.47,,968.87
07/02/2022,DEB,UBER   *TRIP,7.15,,977.34
07/02/2022,DEB,UBER   *TRIP,6,,984.49
07/02/2022,DEB,UBER   *TRIP,9.71,,990.49
07/02/2022,DEB,UBER   *TRIP,8.82,,1000.2
07/02/2022,BP,SAVE THE CHANGE,3.63,,1009.02
07/02/2022,FPO,MISS D WU,59,,1012.65
07/02/2022,DEB,MUANG THAI 9 LTD,45.95,,1071.65
07/02/2022,DEB,STARBUCKS,17.64,,1117.6
07/02/2022,DEB,BOOTSKILBURN,4.89,,1135.24
07/02/2022,DEB,UBER   *TRIP,11.44,,1140.13
07/02/2022,DEB,MCDONALDS,10.51,,1151.57
07/02/2022,DEB,UBER   *TRIP,8.93,,1162.08
07/02/2022,DEB,WELCOME BREAK-NEWP,7.75,,1171.01
07/02/2022,DEB,TESCO STORES 5244,7.75,,1178.76
07/02/2022,DEB,UBER   *TRIP,7.4,,1186.51
07/02/2022,DEB,UBER   *TRIP,1,,1193.91
07/02/2022,DEB,LIDL GB  NOTTINGHA,7.86,,1194.91
04/02/2022,DEB,ATRIUM JUBILEE 1,4.25,,1202.77
04/02/2022,DEB,BookingUK (LTD),,30.6,1207.02
04/02/2022,BP,SAVE THE CHANGE,0.46,,1176.42
03/02/2022,DEB,BookingUK (LTD),187.96,,1176.88
03/02/2022,DEB,LIDL GB  NOTTINGHA,14.58,,1364.84
03/02/2022,BP,SAVE THE CHANGE,1.69,,1379.42
02/02/2022,DEP,CLUB LLOYDS WAIVED,,3,1381.11
02/02/2022,PAY,CLUB LLOYDS FEE,3,,1378.11
02/02/2022,DEB,Subway 32610 Midla,6.19,,1381.11
02/02/2022,DEB,LIDL GB NOTTINGHAM,5.47,,1387.3
02/02/2022,DEB,ATRIUM JUBILEE 1,2.65,,1392.77
02/02/2022,FPO,MISS D WU,7,,1395.42
02/02/2022,CPT,LNK TESCO HK R NOT,50,,1402.42
02/02/2022,FPO,TAMBA TAM,8,,1452.42
02/02/2022,BP,SAVE THE CHANGE,0.35,,1460.42
01/02/2022,,INTEREST (GROSS),,0.48,1460.77
01/02/2022,DEB,AMZNMktplace,23.85,,1460.29
01/02/2022,DEB,HEAVENLY DESSERTS,17.8,,1484.14
01/02/2022,TFR,R LAWRENCE,,150,1501.94
01/02/2022,DD,BARCLAYS UK MTGES,981.71,,1351.94
01/02/2022,DD,NOTTM CITY COUNC,157,,2333.65
01/02/2022,DD,OCTOPUS ENERGY,90,,2490.65
01/02/2022,DD,SEVERN TRENT WATER,41.89,,2580.65
01/02/2022,SO,ESAVINGS ACCOUNT,300,,2622.54
01/02/2022,BP,SAVE THE CHANGE,0.88,,2922.54
31/01/2022,DEB,UBER   *TRIP,5.12,,2923.42
31/01/2022,DEB,UBER   *TRIP,1,,2928.54
31/01/2022,BP,SAVE THE CHANGE,2.48,,2929.54
31/01/2022,DEB,LIDL GB NOTTINGHAM,58.54,,2932.02
31/01/2022,FPO,TAMBA TAM,10,,2990.56
31/01/2022,FPO,TAMBA TAM,10,,3000.56
31/01/2022,DEB,CASSAL RESTAURANTS,17,,3010.56
31/01/2022,DEB,AMZNMktplace,11.99,,3027.56
31/01/2022,FPO,MISS D WU,10,,3039.55
31/01/2022,FPO,MISS D WU,5,,3049.55
28/01/2022,DEB,SUMUP  *LTP,24,,3054.55
28/01/2022,DEB,Subway 32610 Midla,6.19,,3078.55
28/01/2022,DEB,ATRIUM JUBILEE 1,4.25,,3084.74
28/01/2022,DEB,TESCO STORES 5653,0.55,,3088.99
28/01/2022,FPO,TRADING212UK,1100,,3089.54
28/01/2022,DD,TALKTALK LIMITED,26.42,,4189.54
28/01/2022,BP,SAVE THE CHANGE,0.77,,4215.96
28/01/2022,BGC,UNIV OF NOTTINGHAM,,3801.84,4216.73
27/01/2022,DEB,LIDL GB  NOTTINGHA,17.23,,414.89
27/01/2022,BP,SAVE THE CHANGE,0.92,,432.12
26/01/2022,DEB,Subway 32610 Midla,6.99,,433.04
26/01/2022,DEB,ATRIUM JUBILEE 1,2.65,,440.03
26/01/2022,DEB,AMZNMktplace,48.44,,442.68
26/01/2022,FPO,TAMBA TAM,10,,491.12
26/01/2022,BP,SAVE THE CHANGE,0.83,,501.12
26/01/2022,FPO,MISS D WU,7,,501.95
25/01/2022,DEB,YE OLDE TRIP TO JE,21.17,,508.95
25/01/2022,FPO,TRADING212UK,200,,530.12
25/01/2022,FPO,VINOTH VINCE,5,,730.12
25/01/2022,BP,SAVE THE CHANGE,1.21,,735.12
24/01/2022,FPI,PAULINA PIPPEN,,320,736.33
24/01/2022,DEB,Audible UK,7.99,,416.33
24/01/2022,DEB,ROLLS ROYCE LEISUR,4.5,,424.32
24/01/2022,DEB,ROLLS ROYCE LEISUR,4.3,,428.82
24/01/2022,BP,SAVE THE CHANGE,1.46,,433.12
24/01/2022,DEB,MOWGLI STREET FOOD,35.85,,434.58
24/01/2022,DEB,NOTTINGHAM CASTLE,19,,470.43
21/01/2022,DEB,LIDL GB NOTTINGHAM,18.94,,489.43
21/01/2022,DEB,ATRIUM JUBILEE 1,2.3,,508.37
21/01/2022,DEB,CAFFE NERO NOTTING,9.45,,510.67
21/01/2022,CPT,LNK TESCO HK R NOT,40,,520.12
21/01/2022,BP,SAVE THE CHANGE,0.57,,560.12
20/01/2022,FPO,TRADING212UK,300,,560.69
20/01/2022,FPI,SHEILA SMITH,,380,860.69
20/01/2022,DEB,ORIENTAL MART HYDR,9.78,,480.69
20/01/2022,DEB,GREGGS,2.65,,490.47
20/01/2022,BP,SAVE THE CHANGE,1.31,,493.12
19/01/2022,DEB,Subway 32610 Midla,6.19,,494.43
19/01/2022,DEB,ATRIUM JUBILEE 1,2.5,,500.62
19/01/2022,BP,SAVE THE CHANGE,0.69,,503.12
18/01/2022,FPO,MISS D WU,6,,503.81
18/01/2022,FPO,TAMBA TAM,10,,509.81
18/01/2022,DEB,LIDL GB  NOTTINGHA,17.31,,519.81
18/01/2022,BP,SAVE THE CHANGE,0.1,,537.12
17/01/2022,DEB,CAVES,19.9,,537.22
17/01/2022,DD,VIRGIN MEDIA PYMTS,25.5,,557.12
17/01/2022,DD,O2,17.06,,582.62
17/01/2022,BP,SAVE THE CHANGE,3.42,,599.68
17/01/2022,DEB,MUSEUM,16.4,,603.1
17/01/2022,DEB,200 DEGREES,9.7,,619.5
17/01/2022,DEB,POUNDLAND LTD 1718,8.75,,629.2
17/01/2022,FPO,TAMBA TAM,115,,637.95
17/01/2022,DEB,LIDL GB  NOTTINGHA,20.45,,752.95
14/01/2022,DEB,Subway 32610 Midla,6.19,,773.4
14/01/2022,DEB,ORIENTAL MART HYDR,5.1,,779.59
14/01/2022,DEB,AMZNMktplace,12.99,,784.69
14/01/2022,BP,SAVE THE CHANGE,0.51,,797.68
14/01/2022,FPO,ANTIGONI ABRAHMS,6,,798.19
13/01/2022,DEB,HPI INSTANT INK UK,3.49,,804.19
13/01/2022,BP,SAVE THE CHANGE,1.16,,807.68
12/01/2022,DEB,TESCO STORE 2960,12.2,,808.84
12/01/2022,DEB,Subway 32610 Midla,6.99,,821.04
12/01/2022,DEB,ATRIUM JUBILEE 1,2.65,,828.03
12/01/2022,BP,SAVE THE CHANGE,0.21,,830.68
11/01/2022,DEB,RAJAH FOOD STORE L,38.79,,830.89
11/01/2022,BP,SAVE THE CHANGE,0.52,,869.68
10/01/2022,DEB,YANKEE STORE,19.48,,870.2
10/01/2022,BP,SAVE THE CHANGE,2.99,,889.68
10/01/2022,DEB,DISCO BOWL NOTTING,20.5,,892.67
10/01/2022,DEB,FUNSTATION,15,,913.17
10/01/2022,DEB,MCDONALDS,13.87,,928.17
10/01/2022,DEB,POUNDLAND LTD 1718,13,,942.04
10/01/2022,DEB,POUNDLAND LTD 1726,7.5,,955.04
10/01/2022,DEB,LIDL GB NOTTINGHAM,5.67,,962.54
10/01/2022,DEB,UBER   *TRIP,5.12,,968.21
10/01/2022,DEB,UBER   *TRIP,1,,973.33
10/01/2022,DEB,AMZ*Zeina Foods,,14.5,974.33
07/01/2022,DEB,TESCO STORE 2960,18.35,,959.83
07/01/2022,BP,SAVE THE CHANGE,3.67,,978.18
06/01/2022,FPO,MISS D WU,1,,981.85
06/01/2022,DEB,LIDL GB  NOTTINGHA,12.54,,982.85
06/01/2022,DEB,Subway 39497 Victo,6.19,,995.39
06/01/2022,DEB,TESCO STORE 2960,1.15,,1001.58
06/01/2022,DEB,AMZNMktplace,51.05,,1002.73
06/01/2022,DEB,Amazon.co.uk*PU3OT,6.4,,1053.78
06/01/2022,BP,SAVE THE CHANGE,0.09,,1060.18
05/01/2022,DEP,CLUB LLOYDS WAIVED,,3,1060.27
05/01/2022,PAY,CLUB LLOYDS FEE,3,,1057.27
05/01/2022,DEB,UBER   *TRIP,5.91,,1060.27
05/01/2022,DEB,NEW STREET HCO,39,,1066.18
05/01/2022,BP,SAVE THE CHANGE,1.51,,1105.18
04/01/2022,,INTEREST (GROSS),,1.09,1106.69
04/01/2022,FPO,ROBERT RECORD,14,,1105.6
04/01/2022,DEB,BIRMINGHAM NS TVM,42.6,,1119.6
04/01/2022,DEB,WAGAMAMA BIRMINGHA,24.85,,1162.2
04/01/2022,DEB,H & M,17.99,,1187.05
04/01/2022,DEB,Caffe Concerto,15.05,,1205.04
04/01/2022,DEB,UBER   *TRIP,1,,1220.09
04/01/2022,FPO,TRADING212UK,700,,1221.09
04/01/2022,DD,BARCLAYS UK MTGES,981.71,,1921.09
04/01/2022,DD,NOTTM CITY COUNC,157,,2902.8
04/01/2022,DD,OCTOPUS ENERGY,90,,3059.8
04/01/2022,DD,SEVERN TRENT WATER,41.89,,3149.8
04/01/2022,BP,Q WANG,,782,3191.69
04/01/2022,SO,ESAVINGS ACCOUNT,300,,2409.69
04/01/2022,BP,SAVE THE CHANGE,3.17,,2709.69
04/01/2022,DEB,HOLIDAY INN EXPRES,65,,2712.86
04/01/2022,DEB,LAS IGUANAS - TEMP,37.4,,2777.86
04/01/2022,DEB,UBER   *TRIP,24.08,,2815.26
04/01/2022,DEB,AMZNMktplace,9.99,,2839.34
04/01/2022,DEB,HILTON HOTELS,1,,2849.33
04/01/2022,DEB,AMZNMktplace,190.87,,2850.33
04/01/2022,DEB,HILTON HOTELS,235,,3041.2
04/01/2022,DEB,VIETNAMESE STREET,31.46,,3276.2
31/12/2021,DEB,LIDL GB  NOTTINGHA,11.58,,3307.66
31/12/2021,DEB,AMZNMktplace,13.45,,3319.24
31/12/2021,DD,TALKTALK LIMITED,21,,3332.69
30/12/2021,BP,SAVE THE CHANGE,0.75,,3353.69
29/12/2021,DEB,LIDL GB  NOTTINGHA,17.28,,3354.44
29/12/2021,DEB,AMZNMktplace,5.97,,3371.72
29/12/2021,BP,SAVE THE CHANGE,1.25,,3377.69
29/12/2021,DEB,WILKO RETAIL LIMIT,13,,3378.94
29/12/2021,DEB,UBER   *TRIP,12.42,,3391.94
29/12/2021,DEB,UBER   *TRIP,1,,3404.36
29/12/2021,FPO,TAMBA TAM,85,,3405.36
29/12/2021,DEB,AMZNMktplace,15.9,,3490.36
29/12/2021,DEB,AMZNMktplace,9.99,,3506.26
29/12/2021,FPO,TRADING212UK,200,,3516.25
29/12/2021,CPT,LNK 583 MANSFIELD,100,,3716.25
29/12/2021,DEB,GOOGLE *YouTube Vi,3.49,,3816.25
29/12/2021,FPI,PAULINA PIPPEN,,320,3819.74
24/12/2021,DEB,CINEWORLD NOT CP,31.97,,3499.74
24/12/2021,DEB,AMZNMktplace,12.99,,3531.71
24/12/2021,DEB,Audible UK,7.99,,3544.7
24/12/2021,BP,SAVE THE CHANGE,2.19,,3552.69
23/12/2021,DEB,EAST MIDS RAILWAY,8.4,,3554.88
23/12/2021,DEB,Subway 39497 Victo,6.19,,3563.28
23/12/2021,DEB,AMZNMktplace,14.95,,3569.47
23/12/2021,DEB,AMZNMktplace,11.27,,3584.42
23/12/2021,BP,SAVE THE CHANGE,0.24,,3595.69
22/12/2021,DEB,LIDL GB  NOTTINGHA,10.76,,3595.93
22/12/2021,FPO,TRADING212UK,1000,,3606.69
22/12/2021,BP,SAVE THE CHANGE,0.6,,4606.69
22/12/2021,BGC,UNIV OF NOTTINGHAM,,3801.43,4607.29
21/12/2021,DEB,LIDL GB  NOTTINGHA,27.61,,805.86
21/12/2021,DEB,HOLLAND & BARRETT,15.98,,833.47
21/12/2021,DEB,T K MAXX,11.97,,849.45
21/12/2021,DEB,ORIENTAL MART HYDR,8.85,,861.42
21/12/2021,DEB,AMZNMktplace,13.99,,870.27
21/12/2021,FPO,TRADING212UK,100,,884.26
21/12/2021,FPO,TRADING212UK,700,,984.26
21/12/2021,FPI,Q WANG,,1000,1684.26
21/12/2021,BP,SAVE THE CHANGE,0.6,,684.26
20/12/2021,FPO,TRADING212UK,300,,684.86
20/12/2021,FPI,SHEILA SMITH,,380,984.86
20/12/2021,DEB,SAINSBURYS S/MKTS,34.4,,604.86
20/12/2021,BP,SAVE THE CHANGE,1.08,,639.26
20/12/2021,DEB,AMZNMktplace,5.99,,640.34
17/12/2021,DEB,BIRMINGHAM NS T/O,17,,646.33
17/12/2021,DEB,ATRIUM JUBILEE 1,4.25,,663.33
17/12/2021,DEB,AMZNMktplace,31.99,,667.58
17/12/2021,DEB,Amazon.co.uk*8J9B3,6.69,,699.57
17/12/2021,DEB,ANTIGONI ABRAHMS,6,,706.26
17/12/2021,TFR,R LAWRENCE,,300,712.26
17/12/2021,FPO,MR J LITCHFIELD,340,,412.26
17/12/2021,DD,VIRGIN MEDIA PYMTS,25.5,,752.26
17/12/2021,BP,SAVE THE CHANGE,3,,777.76
16/12/2021,DEB,COMFORT INN BIRMIN,53.1,,780.76
16/12/2021,DEB,NANDOS BULLRING,39.1,,833.86
16/12/2021,DEB,EAST MIDS RAILWAY,27.5,,872.96
16/12/2021,DEB,WAGAMAMA BIRMINGHA,16.8,,900.46
16/12/2021,DEB,DANTER ATTRACTIONS,7,,917.26
16/12/2021,DEB,DANTER ATTRACTIONS,7,,924.26
16/12/2021,DEB,IZ *EPICURIOSITY L,5.5,,931.26
16/12/2021,DEB,STARBUCKS,4,,936.76
16/12/2021,DD,O2,16.66,,940.76
16/12/2021,BP,SAVE THE CHANGE,0.82,,957.42
15/12/2021,DEB,Subway 32610 Midla,6.19,,958.24
15/12/2021,DEB,AMZNMKTPLACE AMAZO,11.99,,964.43
15/12/2021,CPT,LOYD LOYD 36 - 38,40,,976.42
15/12/2021,BP,SAVE THE CHANGE,1.4,,1016.42
14/12/2021,FPO,TAMBA TAM,10,,1017.82
14/12/2021,DEB,LIDL GB  NOTTINGHA,25.12,,1027.82
14/12/2021,DEB,AMZNMktplace,12.99,,1052.94
14/12/2021,DEB,HPI INSTANT INK UK,3.49,,1065.93
14/12/2021,BP,SAVE THE CHANGE,0.5,,1069.42
13/12/2021,DEB,Audible UK,18,,1069.92
13/12/2021,DEB,SUMUP  *CODE 34,22.5,,1087.92
13/12/2021,BP,SAVE THE CHANGE,2.78,,1110.42
13/12/2021,DEB,LAND ROVER SOCIAL,5.55,,1113.2
13/12/2021,DEB,THE BLIND RABBIT,9.25,,1118.75
13/12/2021,DEB,THE BLIND RABBIT,7.95,,1128
13/12/2021,FPO,TAMBA TAM,15,,1135.95
13/12/2021,DEB,No. Twelve,45.63,,1150.95
13/12/2021,DEB,ATRIUM JUBILEE 1,2.65,,1196.58
10/12/2021,DEP,CLUB LLOYDS WAIVED,,3,1199.23
10/12/2021,PAY,CLUB LLOYDS FEE,3,,1196.23
10/12/2021,DEB,Subway 32610 Midla,6.19,,1199.23
10/12/2021,DEB,ANTIGONI ABRAHMS,6,,1205.42
09/12/2021,BP,SAVE THE CHANGE,0.42,,1211.42
08/12/2021,DEB,AMZNMktplace,9.99,,1211.84
08/12/2021,DEB,AMZNMktplace,8.59,,1221.83
08/12/2021,BP,SAVE THE CHANGE,0.8,,1230.42
07/12/2021,FPO,TAMBA TAM,10,,1231.22
07/12/2021,FPO,TAMBA TAM,95,,1241.22
07/12/2021,DEB,LIDL GB  NOTTINGHA,17.2,,1336.22
07/12/2021,BP,SAVE THE CHANGE,0.63,,1353.42
06/12/2021,DEB,ORIENTAL MART HYDR,27.97,,1354.05
06/12/2021,DEB,TESCO STORES 6735,3.4,,1382.02
06/12/2021,BP,SAVE THE CHANGE,1.56,,1385.42
06/12/2021,CPT,LNK TESCO LONG ROW,40,,1386.98
06/12/2021,DEB,SUMUP  *TODO LATIN,10,,1426.98
06/12/2021,DEB,ATRIUM JUBILEE 1,4.25,,1436.98
03/12/2021,FPO,ANDREW MUMBI,24,,1441.23
03/12/2021,DEB,Subway 32610 Midla,6.19,,1465.23
03/12/2021,BP,SAVE THE CHANGE,0.15,,1471.42
02/12/2021,DEB,ANTIGONI ABRAHMS,6,,1471.57
02/12/2021,DEB,LIDL GB  NOTTINGHA,10.85,,1477.57
02/12/2021,BP,SAVE THE CHANGE,0.82,,1488.42
01/12/2021,,INTEREST (GROSS),,0.68,1489.24
01/12/2021,FPO,VINOTH VINCE,10,,1488.56
01/12/2021,DEB,Amazon.co.uk*072AV,12.99,,1498.56
01/12/2021,DEB,Subway 32610 Midla,6.19,,1511.55
01/12/2021,TFR,R LAWRENCE,,191.99,1517.74
01/12/2021,DD,BARCLAYS UK MTGES,981.71,,1325.75
01/12/2021,DD,NOTTM CITY COUNC,157,,2307.46
01/12/2021,DD,OCTOPUS ENERGY,90,,2464.46
01/12/2021,DD,SEVERN TRENT WATER,41.86,,2554.46
01/12/2021,SO,ESAVINGS ACCOUNT,300,,2596.32
01/12/2021,BP,SAVE THE CHANGE,0.34,,2896.32
30/11/2021,FPO,TAMBA TAM,10,,2896.66
30/11/2021,DEB,RAJAH FOOD STORE L,7.66,,2906.66
30/11/2021,BP,SAVE THE CHANGE,1.19,,2914.32
29/11/2021,DEB,REVOLUTION DE CUBA,8.75,,2915.51
29/11/2021,DEB,REVOLUTION DE CUBA,8.75,,2924.26
29/11/2021,DEB,UBER   *EATS,35.31,,2933.01
29/11/2021,FPO,TRADING212UK,1500,,2968.32
29/11/2021,BP,SAVE THE CHANGE,1.95,,4468.32
29/11/2021,BGC,UNIV OF NOTTINGHAM,,3801.83,4470.27
29/11/2021,FPO,ANDREW MUMBI,15,,668.44
29/11/2021,DEB,LIDL GB  NOTTINGHA,19.39,,683.44
29/11/2021,DEB,LIDL GB  NOTTINGHA,18.99,,702.83
29/11/2021,DEB,AMZNMktplace,6.49,,721.82
26/11/2021,DEB,AMZNMktplace,9.99,,728.31
26/11/2021,DEB,Subway 32610 Midla,6.19,,738.3
26/11/2021,FPO,TRADING212UK,400,,744.49
26/11/2021,FPI,P PROKURAT,,320,1144.49
26/11/2021,DD,TALKTALK LIMITED,21,,824.49
25/11/2021,DEB,ANTIGONI ABRAHMS,6,,845.49
25/11/2021,BP,SAVE THE CHANGE,0.82,,851.49
24/11/2021,FPO,TAMBA TAM,10,,852.31
24/11/2021,FPO,MARIA DONNARUMMA,75,,862.31
24/11/2021,DEB,Audible UK,7.99,,937.31
24/11/2021,DEB,Subway 32610 Midla,6.19,,945.3
24/11/2021,BP,SAVE THE CHANGE,0.94,,951.49
24/11/2021,BGC,GOOGLE IRELAND,,63.7,952.43
23/11/2021,DEB,LIDL GB  NOTTINGHA,17.19,,888.73
23/11/2021,DEB,RAJAH FOOD STORE L,11.87,,905.92
23/11/2021,BP,SAVE THE CHANGE,0.13,,917.79
22/11/2021,DEB,AMZNMktplace,17.87,,917.92
22/11/2021,BP,SAVE THE CHANGE,5.4,,935.79
22/11/2021,DEB,LIDL GB  NOTTINGHA,23.44,,941.19
22/11/2021,DEB,ORIENTAL MART HYDR,13.11,,964.63
22/11/2021,DEB,AMZNMktplace,10.99,,977.74
22/11/2021,DEB,WILKO RETAIL LIMIT,7.75,,988.73
22/11/2021,DEB,200 DEGREES,5.9,,996.48
22/11/2021,DEB,HOLLAND & BARRETT,4.35,,1002.38
22/11/2021,FPO,TAMBA TAM,10,,1006.73
22/11/2021,DEB,Subway 32610 Midla,6.19,,1016.73
22/11/2021,DEB,STARBUCKS,6.1,,1022.92
22/11/2021,FPI,SHEILA SMITH,,380,1029.02
19/11/2021,DEB,LIDL GB  NOTTINGHA,12.52,,649.02
19/11/2021,DEB,ATRIUM JUBILEE 1,4.25,,661.54
19/11/2021,FPO,TRADING212UK,400,,665.79
19/11/2021,BP,SAVE THE CHANGE,0.51,,1065.79
18/11/2021,DEB,HPI INSTANT INK UK,3.49,,1066.3
18/11/2021,BP,SAVE THE CHANGE,1.72,,1069.79
17/11/2021,DEB,AMZNMktplace,25.44,,1071.51
17/11/2021,DEB,Subway 32610 Midla,6.19,,1096.95
17/11/2021,DEB,ATRIUM JUBILEE 1,2.65,,1103.14
17/11/2021,DD,VIRGIN MEDIA PYMTS,25.5,,1105.79
17/11/2021,BP,SAVE THE CHANGE,1,,1131.29
16/11/2021,FPO,TAMBA TAM,10,,1132.29
16/11/2021,DEB,LIDL GB  NOTTINGHA,23.9,,1142.29
16/11/2021,DEB,Amazon.co.uk*Y39VW,8.1,,1166.19
16/11/2021,DD,O2,16.66,,1174.29
15/11/2021,DEB,BLEND COFFEE HOUSE,3,,1190.95
15/11/2021,DEB,SUMUP  *LOS TRAVIE,70,,1193.95
15/11/2021,BP,SAVE THE CHANGE,2.59,,1263.95
15/11/2021,DEB,JURYS INN EAST MID,12.55,,1266.54
15/11/2021,DEB,ATRIUM JUBILEE 1,4.25,,1279.09
15/11/2021,DEB,AMZNMktplace,2.77,,1283.34
12/11/2021,DEB,Subway 32610 Midla,6.19,,1286.11
12/11/2021,DEB,ANTIGONI ABRAHMS,6,,1292.3
12/11/2021,DEB,ATRIUM JUBILEE 1,2.65,,1298.3
12/11/2021,BP,SAVE THE CHANGE,0.76,,1300.95
11/11/2021,DEB,LIDL GB  NOTTINGHA,20.24,,1301.71
11/11/2021,FPO,TRADING212UK,400,,1321.95
11/11/2021,BP,SAVE THE CHANGE,1.16,,1721.95
10/11/2021,DEB,Subway 32610 Midla,6.19,,1723.11
10/11/2021,DEB,ATRIUM JUBILEE 1,2.65,,1729.3
10/11/2021,FPO,L CATATE,20,,1731.95
10/11/2021,FPO,TAMBA TAM,10,,1751.95
09/11/2021,BP,SAVE THE CHANGE,0.35,,1761.95
08/11/2021,DEB,LIDL GB  NOTTINGHA,18.9,,1762.3
08/11/2021,DEB,REVOLUTION DE CUBA,8.75,,1781.2
08/11/2021,BP,SAVE THE CHANGE,2.82,,1789.95
08/11/2021,DEB,ORIENTAL MART HYDR,5.49,,1792.77
08/11/2021,DEB,ATRIUM JUBILEE 1,4.25,,1798.26
05/11/2021,DEB,Subway 32610 Midla,6.19,,1802.51
05/11/2021,DEB,ATRIUM JUBILEE 1,4.25,,1808.7
05/11/2021,BP,SAVE THE CHANGE,0.08,,1812.95
04/11/2021,DEB,LIDL GB  NOTTINGHA,9.92,,1813.03
04/11/2021,BP,SAVE THE CHANGE,1.16,,1822.95
03/11/2021,DEB,Subway 32610 Midla,6.19,,1824.11
03/11/2021,DEB,ATRIUM JUBILEE 1,2.65,,1830.3
03/11/2021,FPO,TAMBA TAM,10,,1832.95
03/11/2021,BP,SAVE THE CHANGE,1.23,,1842.95
02/11/2021,DEP,CLUB LLOYDS WAIVED,,3,1844.18
02/11/2021,PAY,CLUB LLOYDS FEE,3,,1841.18
02/11/2021,DEB,LIDL GB  NOTTINGHA,5.12,,1844.18
02/11/2021,DEB,ATRIUM JUBILEE 1,2.65,,1849.3
02/11/2021,FPO,TRADING212UK,500,,1851.95
01/11/2021,,INTEREST (GROSS),,0.78,2351.95
01/11/2021,FPI,Q WANG,,1000,2351.17
01/11/2021,DD,BARCLAYS UK MTGES,981.71,,1351.17
01/11/2021,DD,NOTTM CITY COUNC,157,,2332.88
01/11/2021,DD,OCTOPUS ENERGY,90,,2489.88
01/11/2021,DD,SEVERN TRENT WATER,35.32,,2579.88
01/11/2021,SO,ESAVINGS ACCOUNT,300,,2615.2
01/11/2021,BP,SAVE THE CHANGE,1.76,,2915.2
01/11/2021,DEB,LIDL GB  NOTTINGHA,10.8,,2916.96
01/11/2021,DEB,STARBUCKS,5.6,,2927.76
29/10/2021,DEB,Subway 32610 Midla,6.19,,2933.36
29/10/2021,DEB,FALAFEL,6,,2939.55
29/10/2021,DEB,FALAFEL,3,,2945.55
29/10/2021,DEB,ATRIUM JUBILEE 1,2.65,,2948.55
29/10/2021,FPO,TRADING212UK,1200,,2951.2
29/10/2021,DD,TALKTALK LIMITED,21,,4151.2
29/10/2021,BP,SAVE THE CHANGE,0.43,,4172.2
28/10/2021,DEB,ANTIGONI ABRAHMS,6,,4172.63
28/10/2021,DEB,LIDL GB  NOTTINGHA,13.57,,4178.63
28/10/2021,BP,SAVE THE CHANGE,1.16,,4192.2
28/10/2021,BGC,UNIV OF NOTTINGHAM,,3801.44,4193.36
27/10/2021,FPO,TAMBA TAM,10,,391.92
27/10/2021,DEB,Subway 32610 Midla,6.19,,401.92
27/10/2021,DEB,ATRIUM JUBILEE 1,1.65,,408.11
26/10/2021,FPO,TRADING212UK,350,,409.76
26/10/2021,BP,SAVE THE CHANGE,0.54,,759.76
25/10/2021,DEB,REVOLUTION DE CUBA,9.75,,760.3
25/10/2021,DEB,CARTWHEEL COFFEE L,6.71,,770.05
25/10/2021,BP,SAVE THE CHANGE,2.81,,776.76
25/10/2021,DEB,PRICKLY PEAR,91.5,,779.57
25/10/2021,DEB,ORIENTAL MART HYDR,8.33,,871.07
25/10/2021,DEB,Audible UK,7.99,,879.4
25/10/2021,DEB,LIDL GB  NOTTINGHA,21.18,,887.39
22/10/2021,DEB,Subway 32610 Midla,6.19,,908.57
22/10/2021,FPI,PAULINA PIPPEN,,320,914.76
22/10/2021,FPO,TRADING212UK,400,,594.76
22/10/2021,BP,SAVE THE CHANGE,0.97,,994.76
21/10/2021,FPO,ANTIGONI ABRAHMS,6,,995.73
21/10/2021,DEB,SAINSBURYS S/MKTS,29.3,,1001.73
21/10/2021,DEB,AMZNMktplace,25.73,,1031.03
21/10/2021,BP,SAVE THE CHANGE,0.81,,1056.76
20/10/2021,FPI,SHEILA SMITH,,380,1057.57
20/10/2021,DEB,Subway 32610 Midla,6.19,,677.57
20/10/2021,FPO,TAMBA TAM,10,,683.76
20/10/2021,BP,SAVE THE CHANGE,0.71,,693.76
19/10/2021,DEB,SP * HOMEDETAIL-UK,239,,694.47
19/10/2021,DEB,NON-GBP PURCH FEE,0.5,,933.47
19/10/2021,DEB,NON-GBP TRANS FEE,0.54,,933.97
19/10/2021,DEB,EB 2021 IEEE CONFE,18.29,,934.51
19/10/2021,CPT,LNK NOTTINGHAM UNI,40,,952.8
19/10/2021,FPO,TRADING212UK,200,,992.8
19/10/2021,BP,SAVE THE CHANGE,1.42,,1192.8
18/10/2021,DEB,AMZNMktplace,15.49,,1194.22
18/10/2021,DEB,AMZNMktplace,9.99,,1209.71
18/10/2021,DEB,REVOLUTION DE CUBA,8.75,,1219.7
18/10/2021,DEB,CAFFE NERO NOTTING,3.35,,1228.45
18/10/2021,DEB,GREGGS PLC,2,,1231.8
18/10/2021,DD,VIRGIN MEDIA PYMTS,25.5,,1233.8
18/10/2021,DD,O2,16.66,,1259.3
18/10/2021,BP,SAVE THE CHANGE,3.19,,1275.96
18/10/2021,DEB,LIDL GB  NOTTINGHA,8.87,,1279.15
18/10/2021,DEB,ATRIUM JUBILEE 1,2.65,,1288.02
15/10/2021,DEB,Subway 32610 Midla,6.19,,1290.67
15/10/2021,DEB,SOUTHBANK BAR,5.6,,1296.86
15/10/2021,DEB,ATRIUM JUBILEE 1,4.25,,1302.46
15/10/2021,DEB,TESCO STORES 6735,2.25,,1306.71
15/10/2021,BP,SAVE THE CHANGE,0.51,,1308.96
14/10/2021,FPO,ANTIGONI ABRAHMS,6,,1309.47
14/10/2021,DEB,HPI INSTANT INK UK,3.49,,1315.47
14/10/2021,BP,SAVE THE CHANGE,1.77,,1318.96
13/10/2021,DEB,AMZNMktplace,35.04,,1320.73
13/10/2021,DEB,Subway 32610 Midla,6.19,,1355.77
13/10/2021,TFR,R LAWRENCE,,400,1361.96
13/10/2021,FPO,MR J LITCHFIELD,481,,961.96
13/10/2021,BP,SAVE THE CHANGE,0.03,,1442.96
12/10/2021,FPO,TAMBA TAM,10,,1442.99
12/10/2021,DEB,LIDL GB  NOTTINGHA,5.97,,1452.99
12/10/2021,BP,SAVE THE CHANGE,0.25,,1458.96
11/10/2021,DEB,REVOLUTION DE CUBA,8.75,,1459.21
11/10/2021,BP,SAVE THE CHANGE,2.99,,1467.96
11/10/2021,DEB,ORIENTAL MART HYDR,5.84,,1470.95
11/10/2021,DEB,SUPERDRUG STORES P,3.9,,1476.79
11/10/2021,DEB,HARTLEYS SANDWICH,2.95,,1480.69
11/10/2021,DEB,PRICKLY PEAR,12.5,,1483.64
11/10/2021,DEB,LIDL GB  NOTTINGHA,7.69,,1496.14
08/10/2021,DEB,Amazon.co.uk*8T0UU,1.19,,1503.83
08/10/2021,DEB,31K,12,,1505.02
08/10/2021,DEB,STARBUCKS,7.4,,1517.02
08/10/2021,DEB,Subway 32610 Midla,6.89,,1524.42
08/10/2021,DEB,ATRIUM JUBILEE 1,2.65,,1531.31
08/10/2021,BP,SAVE THE CHANGE,2.3,,1533.96
07/10/2021,FPO,ANTIGONI ABRAHMS,6,,1536.26
07/10/2021,DEB,AMZNMktplace,19.99,,1542.26
07/10/2021,DEB,LIDL GB  NOTTINGHA,11.11,,1562.25
07/10/2021,DEB,AMZNMktplace,6.5,,1573.36
07/10/2021,DEB,AMZNMktplace,5.1,,1579.86
07/10/2021,BP,SAVE THE CHANGE,0.81,,1584.96
06/10/2021,DEB,Subway 32610 Midla,6.19,,1585.77
06/10/2021,BP,SAVE THE CHANGE,0.36,,1591.96
05/10/2021,DEB,AMZNMktplace,23.99,,1592.32
05/10/2021,DEB,LIDL GB  NOTTINGHA,12.65,,1616.31
05/10/2021,BP,SAVE THE CHANGE,1.72,,1628.96
04/10/2021,DEP,CLUB LLOYDS WAIVED,,3,1630.68
04/10/2021,PAY,CLUB LLOYDS FEE,3,,1627.68
04/10/2021,DEB,The Speciality Cof,22.2,,1630.68
04/10/2021,DEB,ORIENTAL MART HYDR,12.08,,1652.88
04/10/2021,BP,SAVE THE CHANGE,2.02,,1664.96
04/10/2021,DEB,AMZNMktplace,22.84,,1666.98
04/10/2021,DEB,SUMUP  *TODO LATIN,12.5,,1689.82
04/10/2021,DEB,U CANTEEN,10.5,,1702.32
04/10/2021,FPO,TRADING212UK,500,,1712.82
01/10/2021,,INTEREST (GROSS),,0.79,2212.82
01/10/2021,DEB,EB *SPEED DATING O,22.15,,2212.03
01/10/2021,DEB,AMZNMktplace,8.99,,2234.18
01/10/2021,FPO,ABAYOMI ADAMS,370,,2243.17
01/10/2021,DD,BARCLAYS UK MTGES,981.71,,2613.17
01/10/2021,DD,NOTTM CITY COUNC,157,,3594.88
01/10/2021,DD,OCTOPUS ENERGY,90,,3751.88
01/10/2021,DD,SEVERN TRENT WATER,35.32,,3841.88
01/10/2021,SO,Q WANG,,1000,3877.2
01/10/2021,SO,ESAVINGS ACCOUNT,300,,2877.2
01/10/2021,BP,SAVE THE CHANGE,0.15,,3177.2
30/09/2021,FPO,ANTIGONI ABRAHMS,6,,3177.35
30/09/2021,DEB,AMZNMktplace,95.99,,3183.35
30/09/2021,DEB,LIDL GB  NOTTINGHA,16.86,,3279.34
30/09/2021,BP,SAVE THE CHANGE,0.81,,3296.2
29/09/2021,DEB,Subway 32610 Midla,6.19,,3297.01
29/09/2021,FPO,TRADING212UK,1500,,3303.2
29/09/2021,FPO,TAMBA TAM,10,,4803.2
29/09/2021,BP,SAVE THE CHANGE,0.23,,4813.2
29/09/2021,BGC,UNIV OF NOTTINGHAM,,4091.83,4813.43
28/09/2021,DEB,AMZNMktplace,47.77,,721.6
28/09/2021,BP,SAVE THE CHANGE,1.28,,769.37
27/09/2021,DEB,Amazon.co.uk*CM96E,22.27,,770.65
27/09/2021,DEB,REVOLUTION DE CUBA,5.45,,792.92
27/09/2021,DEB,CAFFE NERO NOTTING,10,,798.37
27/09/2021,DD,TALKTALK LIMITED,21,,808.37
27/09/2021,BP,SAVE THE CHANGE,3.22,,829.37
27/09/2021,DEB,IKEA LTD SHOP ONLI,110,,832.59
27/09/2021,DEB,AMZNMktplace,18.99,,942.59
27/09/2021,DEB,ORIENTAL MART HYDR,13.04,,961.58
27/09/2021,DEB,IZ *BELLAPAELLA,7,,974.62
27/09/2021,DEB,LIDL GB  NOTTINGHA,6.32,,981.62
27/09/2021,DEB,LIDL GB  NOTTINGHA,4.57,,987.94
27/09/2021,DEB,AMZNMktplace,3.82,,992.51
27/09/2021,FPO,TRADING212UK,400,,996.33
27/09/2021,FPI,PAULINA PIPPEN,,320,1396.33
24/09/2021,DEB,LIDL GB  NOTTINGHA,9.86,,1076.33
24/09/2021,DEB,Audible UK,7.99,,1086.19
24/09/2021,DEB,Subway 32610 Midla,6.19,,1094.18
22/09/2021,BP,SAVE THE CHANGE,1.65,,1100.37
21/09/2021,FPO,TAMBA TAM,10,,1102.02
21/09/2021,DEB,LIDL GB  NOTTINGHA,7.16,,1112.02
21/09/2021,DEB,Subway 32610 Midla,6.19,,1119.18
21/09/2021,FPO,TRADING212UK,400,,1125.37
21/09/2021,BP,SAVE THE CHANGE,0.6,,1525.37
20/09/2021,FPI,SHEILA SMITH,,380,1525.97
20/09/2021,DEB,ESCOBAR,21.4,,1145.97
20/09/2021,BP,SAVE THE CHANGE,1.11,,1167.37
20/09/2021,DEB,AMZNMktplace,6.99,,1168.48
20/09/2021,DEB,ORIENTAL MART HYDR,6.94,,1175.47
20/09/2021,DEB,TESCO STORE 2960,3.1,,1182.41
20/09/2021,DEB,T K MAXX,2.99,,1185.51
20/09/2021,FPO,TRADING212UK,400,,1188.5
20/09/2021,DEB,AMZNMktplace,9.99,,1588.5
17/09/2021,DEB,Subway 32610 Midla,6.89,,1598.49
17/09/2021,DEB,Subway 32610 Midla,3.99,,1605.38
17/09/2021,DD,VIRGIN MEDIA PYMTS,25.5,,1609.37
17/09/2021,BP,SAVE THE CHANGE,1.13,,1634.87
16/09/2021,FPO,ANTIGONI ABRAHMS,6,,1636
16/09/2021,DEB,AMZNMktplace,11.99,,1642
16/09/2021,DEB,LIDL GB  NOTTINGHA,9.49,,1653.99
16/09/2021,DEB,AMZNMKTPLACE AMAZO,6.39,,1663.48
16/09/2021,DD,O2,16.66,,1669.87
16/09/2021,BP,SAVE THE CHANGE,0.81,,1686.53
15/09/2021,DEB,Subway 32610 Midla,6.19,,1687.34
15/09/2021,BP,SAVE THE CHANGE,0.56,,1693.53
14/09/2021,FPO,TAMBA TAM,10,,1694.09
14/09/2021,DEB,HPI INSTANT INK UK,3.49,,1704.09
14/09/2021,DEB,AMZNMktplace,14.99,,1707.58
14/09/2021,DEB,LIDL GB  NOTTINGHA,7.96,,1722.57
14/09/2021,BP,SAVE THE CHANGE,1.2,,1730.53
13/09/2021,DEB,AMZNMKTPLACE AMAZO,15.9,,1731.73
13/09/2021,DEB,CAFE CHHINO,7.95,,1747.63
13/09/2021,DEB,REVOLUTION DE CUBA,5.5,,1755.58
13/09/2021,DEB,REVOLUTION DE CUBA,5.45,,1761.08
13/09/2021,BP,SAVE THE CHANGE,1.38,,1766.53
13/09/2021,DEB,ORIENTAL MART HYDR,6.75,,1767.91
13/09/2021,DEB,LIDL GB  NOTTINGHA,8.3,,1774.66
10/09/2021,DEB,LIDL GB  NOTTINGHA,14.68,,1782.96
10/09/2021,DEB,Subway 32610 Midla,6.89,,1797.64
10/09/2021,BP,SAVE THE CHANGE,0.12,,1804.53
09/09/2021,DEB,AMZNMktplace,10.99,,1804.65
09/09/2021,DEB,IKEA LTD SHOP ONLI,55,,1815.64
09/09/2021,DEB,AMZNMktplace,14.89,,1870.64
09/09/2021,FPI,PAULINA PIPPEN,,320,1885.53
09/09/2021,BP,SAVE THE CHANGE,0.02,,1565.53
08/09/2021,DEB,Subway 32610 Midla,5.99,,1565.55
08/09/2021,DEB,AMZNMktplace,3.99,,1571.54
08/09/2021,TFR,R LAWRENCE,,500,1575.53
08/09/2021,FPO,MR J LITCHFIELD,544.84,,1075.53
08/09/2021,FPO,TAMBA TAM,10,,1620.37
08/09/2021,BP,SAVE THE CHANGE,0.46,,1630.37
07/09/2021,DEB,LIDL GB  NOTTINGHA,9.54,,1630.83
07/09/2021,BP,SAVE THE CHANGE,0.65,,1640.37
06/09/2021,DEB,SUMUP  *TODO LATIN,15,,1641.02
06/09/2021,DEB,REVOLUTION DE CUBA,5.35,,1656.02
06/09/2021,DD,PURE GYM LTD,19.99,,1661.37
06/09/2021,BP,SAVE THE CHANGE,2.8,,1681.36
06/09/2021,DEB,ORIENTAL MART HYDR,6.99,,1684.16
06/09/2021,DEB,Amazon.co.uk*RJ1R7,32.21,,1691.15
06/09/2021,DEB,LIDL GB  NOTTINGHA,7.96,,1723.36
03/09/2021,DEB,No. Twelve,66.53,,1731.32
03/09/2021,DEB,LIDL GB NOTTINGHAM,9.02,,1797.85
03/09/2021,DEB,Subway 32610 Midla,6.49,,1806.87
03/09/2021,BP,SAVE THE CHANGE,0.46,,1813.36
02/09/2021,DEP,CLUB LLOYDS WAIVED,,3,1813.82
02/09/2021,FPO,ANTIGONI ABRAHMS,6,,1810.82
02/09/2021,PAY,CLUB LLOYDS FEE,3,,1816.82
02/09/2021,DEB,SUMUP  *TODO LATIN,15,,1819.82
02/09/2021,DEB,AMZNMktplace,8.99,,1834.82
02/09/2021,DEB,REVOLUTION DE CUBA,4.55,,1843.81
02/09/2021,BP,SAVE THE CHANGE,0.15,,1848.36
01/09/2021,,INTEREST (GROSS),,0.87,1848.51
01/09/2021,CPT,LNK TESCO HK R NOT,30,,1847.64
01/09/2021,DEB,SHARIF AND SONS SU,23.88,,1877.64
01/09/2021,DEB,Amazon.co.uk*XS1VA,11.97,,1901.52
01/09/2021,FPO,TRADING212UK,500,,1913.49
01/09/2021,FPO,TRADING212UK,100,,2413.49
01/09/2021,TFR,R LAWRENCE,,200,2513.49
01/09/2021,DD,BARCLAYS UK MTGES,981.71,,2313.49
01/09/2021,DD,NOTTM CITY COUNC,157,,3295.2
01/09/2021,DD,OCTOPUS ENERGY,90,,3452.2
01/09/2021,DD,SEVERN TRENT WATER,35.32,,3542.2
01/09/2021,SO,Q WANG,,1000,3577.52
01/09/2021,SO,ESAVINGS ACCOUNT,300,,2577.52
31/08/2021,BP,SAVE THE CHANGE,1.4,,2877.52
31/08/2021,DEB,SAINSBURYS S/MKTS,34.18,,2878.92
31/08/2021,DEB,ANATOLIA TURKISH R,12,,2913.1
31/08/2021,DEB,LIDL GB  NOTTINGHA,13.42,,2925.1
27/08/2021,CPT,LNK TESCO HK R NOT,40,,2938.52
27/08/2021,FPO,TRADING212UK,1500,,2978.52
27/08/2021,DD,TALKTALK LIMITED,21,,4478.52
27/08/2021,BGC,UNIV OF NOTTINGHAM,,3801.43,4499.52
26/08/2021,FPO,ANTIGONI ABRAHMS,6,,698.09
26/08/2021,BP,SAVE THE CHANGE,0.81,,704.09
25/08/2021,DEB,T4 TEA SALOON,14.2,,704.9
25/08/2021,DEB,AMZNMktplace,9.99,,719.1
25/08/2021,FPO,TRADING212UK,300,,729.09
25/08/2021,FPI,ABAYOMI ADAMS,,400,1029.09
25/08/2021,BP,SAVE THE CHANGE,0.06,,629.09
24/08/2021,FPO,TAMBA TAM,10,,629.15
24/08/2021,DEB,AMZNMktplace,18.95,,639.15
24/08/2021,DEB,Audible UK,7.99,,658.1
24/08/2021,FPO,TRADING212UK,300,,666.09
24/08/2021,BP,SAVE THE CHANGE,0.21,,966.09
23/08/2021,DEB,LIDL GB  NOTTINGHA,15.79,,966.3
23/08/2021,DEB,Amazon.co.uk*I0899,12,,982.09
23/08/2021,BP,SAVE THE CHANGE,2.54,,994.09
23/08/2021,DEB,T K MAXX,21.94,,996.63
23/08/2021,DEB,ORIENTAL MART HYDR,11.17,,1018.57
23/08/2021,DEB,AMZNMktplace,5.99,,1029.74
23/08/2021,DEB,LIDL GB  NOTTINGHA,16.09,,1035.73
23/08/2021,DEB,AMZNMktplace,11.27,,1051.82
20/08/2021,FPO,TRADING212UK,300,,1063.09
20/08/2021,FPI,SHEILA SMITH,,380,1363.09
20/08/2021,BP,SAVE THE CHANGE,1.01,,983.09
19/08/2021,DEB,AMZNMktplace,18.5,,984.1
19/08/2021,DEB,HPI INSTANT INK UK,3.49,,1002.6
18/08/2021,FPO,TRADING212UK,400,,1006.09
18/08/2021,BP,SAVE THE CHANGE,0.14,,1406.09
17/08/2021,DEB,LIDL GB  NOTTINGHA,5.86,,1406.23
17/08/2021,DD,VIRGIN MEDIA PYMTS,25.5,,1412.09
16/08/2021,FPO,TRADING212UK,500,,1437.59
16/08/2021,DD,O2,16.66,,1937.59
16/08/2021,BP,SAVE THE CHANGE,0.06,,1954.25
16/08/2021,DEB,AMZNMktplace,5.94,,1954.31
11/08/2021,BP,SAVE THE CHANGE,0.1,,1960.25
10/08/2021,DEB,Amazon.co.uk*BV22U,7.9,,1960.35
10/08/2021,BP,SAVE THE CHANGE,0.6,,1968.25
09/08/2021,DEB,Amazon.co.uk*VM9GG,14.4,,1968.85
09/08/2021,BP,SAVE THE CHANGE,0.02,,1983.25
06/08/2021,DEB,AMZNMktplace,15.99,,1983.27
06/08/2021,DEB,AMZNMktplace,15.99,,1999.26
06/08/2021,DD,PURE GYM LTD,19.99,,2015.25
05/08/2021,BP,SAVE THE CHANGE,0.21,,2035.24
04/08/2021,DEB,Amazon.co.uk*W99XU,25.8,,2035.45
04/08/2021,DEB,AMZNMktplace,9.99,,2061.25
04/08/2021,FPO,TRADING212UK,100,,2071.24
04/08/2021,BP,SAVE THE CHANGE,1.08,,2171.24
03/08/2021,DEP,CLUB LLOYDS WAIVED,,3,2172.32
03/08/2021,PAY,CLUB LLOYDS FEE,3,,2169.32
03/08/2021,DEB,AMZNMktplace,20.99,,2172.32
03/08/2021,DEB,AMZNMktplace,14.44,,2193.31
03/08/2021,DEB,AMZNMktplace,8.49,,2207.75
03/08/2021,TFR,R LAWRENCE,,150,2216.24
02/08/2021,,INTEREST (GROSS),,0.8,2066.24
02/08/2021,FPO,TRADING212UK,500,,2065.44
02/08/2021,DD,BARCLAYS UK MTGES,981.71,,2565.44
02/08/2021,DD,NOTTM CITY COUNC,157,,3547.15
02/08/2021,DD,OCTOPUS ENERGY,90,,3704.15
02/08/2021,DD,SEVERN TRENT WATER,35.32,,3794.15
02/08/2021,SO,Q WANG,,1000,3829.47
02/08/2021,SO,ESAVINGS ACCOUNT,300,,2829.47
30/07/2021,FPO,TRADING212UK,1000,,3129.47
29/07/2021,BP,SAVE THE CHANGE,1.19,,4129.47
29/07/2021,BGC,UNIV OF NOTTINGHAM,,3756.19,4130.66
28/07/2021,DEB,AMZNMktplace,117.79,,374.47
28/07/2021,DEB,LIDL GB  NOTTINGHA,14.02,,492.26
28/07/2021,BP,SAVE THE CHANGE,0.66,,506.28
28/07/2021,FPO,TAMBA TAM,10,,506.94
27/07/2021,DEB,UNION ROOMS,4.34,,516.94
27/07/2021,DEB,CRYSTAL DRAGON,12,,521.28
27/07/2021,FPO,TRADING212UK,400,,533.28
27/07/2021,DD,TALKTALK LIMITED,20.84,,933.28
27/07/2021,BP,SAVE THE CHANGE,1.82,,954.12
26/07/2021,DEB,TIGERMILK EVENTS,9.5,,955.94
26/07/2021,DEB,UNION ROOMS,4.34,,965.44
26/07/2021,DEB,UNION ROOMS,4.34,,969.78
26/07/2021,FPI,ABAYOMI ADAMS,,400,974.12
26/07/2021,BP,SAVE THE CHANGE,2.51,,574.12
26/07/2021,DEB,SKECHERS PLYMOUTH,67,,576.63
26/07/2021,DEB,THE RISE BAKERY,14.75,,643.63
26/07/2021,CPT,LNK BOOZE BUSTERS,50,,658.38
26/07/2021,DEB,THE RISE BAKERY,11.15,,708.38
26/07/2021,DEB,Audible UK,7.99,,719.53
26/07/2021,DEB,PASTIES 4 YOU LTD,2.5,,727.52
26/07/2021,DEB,CAFFE NERO BIRMING,3.6,,730.02
23/07/2021,DEB,THE NEW CONTINENTA,465,,733.62
23/07/2021,DEB,EAST MIDS RAILWAY,155.5,,1198.62
23/07/2021,BP,SAVE THE CHANGE,0.01,,1354.12
23/07/2021,BGC,OPEN UNIVERSITY,,372.32,1354.13
22/07/2021,DEB,AMZNMktplace,12.99,,981.81
22/07/2021,BP,SAVE THE CHANGE,0.83,,994.8
21/07/2021,DEB,AMZNMktplace,12.99,,995.63
21/07/2021,DEB,LIDL GB NOTTINGHAM,8.94,,1008.62
21/07/2021,DEB,Amazon.co.uk*228N1,5.24,,1017.56
21/07/2021,FPO,TRADING212UK,200,,1022.8
21/07/2021,BP,SAVE THE CHANGE,0.08,,1222.8
20/07/2021,FPO,TAMBA TAM,10,,1222.88
20/07/2021,FPI,SHEILA SMITH,,380,1232.88
20/07/2021,DEB,AMZNMktplace,102.94,,852.88
20/07/2021,DEB,AMZNMktplace,12.99,,955.82
20/07/2021,DEB,Amazon.co.uk*1D3K4,4.99,,968.81
20/07/2021,BP,SAVE THE CHANGE,2.05,,973.8
19/07/2021,DEB,SAINSBURYS S/MKTS,21.55,,975.85
19/07/2021,DEB,AMZNMktplace,11.11,,997.4
19/07/2021,DEB,AMZNMktplace,8.75,,1008.51
19/07/2021,DEB,AMZNMktplace,5.54,,1017.26
19/07/2021,DD,VIRGIN MEDIA PYMTS,25.5,,1022.8
19/07/2021,BP,SAVE THE CHANGE,0.96,,1048.3
19/07/2021,FPO,TRADING212UK,150,,1049.26
19/07/2021,DEB,LIDL GB  NOTTINGHA,15.44,,1199.26
19/07/2021,DEB,Audible UK,18,,1214.7
19/07/2021,DEB,SQ *DIVINE COFFEE,9.6,,1232.7
16/07/2021,DEB,TESCO STORES 6735,2,,1242.3
16/07/2021,DD,O2,16.66,,1244.3
15/07/2021,FPO,ANTIGONI ABRAHMS,6,,1260.96
15/07/2021,FPO,ALICJA ALEXANDER,30,,1266.96
15/07/2021,BP,SAVE THE CHANGE,1.08,,1296.96
14/07/2021,DEB,HPI INSTANT INK UK,3.49,,1298.04
14/07/2021,DEB,LIDL GB NOTTINGHAM,11.44,,1301.53
14/07/2021,DEB,AMZNMktplace,8.99,,1312.97
13/07/2021,FPO,TAMBA TAM,10,,1321.96
13/07/2021,BP,SAVE THE CHANGE,0.51,,1331.96
12/07/2021,DEB,GOOGLE *YouTube Vi,3.49,,1332.47
12/07/2021,BP,SAVE THE CHANGE,2.12,,1335.96
12/07/2021,DEB,AMZNMktplace,9.34,,1338.08
12/07/2021,DEB,WILKO RETAIL LIMIT,3.5,,1347.42
12/07/2021,DEB,ORIENTAL MART HYDR,3.26,,1350.92
12/07/2021,DEB,AMZNMKTPLACE AMAZO,25.99,,1354.18
12/07/2021,FPO,ROBERT RECORD,30,,1380.17
12/07/2021,DEB,SAINSBURYS S/MKTS,35.8,,1410.17
09/07/2021,DEB,31K,12,,1445.97
09/07/2021,DEB,AMZNMKTPLACE AMAZO,11.99,,1457.97
09/07/2021,BP,SAVE THE CHANGE,0.8,,1469.96
08/07/2021,FPO,ANTIGONI ABRAHMS,6,,1470.76
08/07/2021,DEB,RAJAH FOOD STORE L,6.2,,1476.76
08/07/2021,BP,SAVE THE CHANGE,0.88,,1482.96
07/07/2021,DEB,TROPICAL SUMMER FE,114.57,,1483.84
07/07/2021,DEB,AMZNMktplace,98.55,,1598.41
07/07/2021,BP,SAVE THE CHANGE,0.85,,1696.96
06/07/2021,FPO,TAMBA TAM,10,,1697.81
06/07/2021,DEB,LIDL GB  NOTTINGHA,5.15,,1707.81
06/07/2021,DD,PURE GYM LTD,19.99,,1712.96
06/07/2021,BP,SAVE THE CHANGE,0.2,,1732.95
05/07/2021,DEB,LIDL GB  NOTTINGHA,11.8,,1733.15
05/07/2021,BP,SAVE THE CHANGE,2.11,,1744.95
05/07/2021,DEB,Lush UK,36,,1747.06
05/07/2021,DEB,ORIENTAL MART HYDR,11.01,,1783.06
05/07/2021,DEB,DOUGHNOTTS BAKERY,6.5,,1794.07
05/07/2021,DEB,LIDL GB  NOTTINGHA,18.39,,1800.57
02/07/2021,DEP,CLUB LLOYDS WAIVED,,3,1818.96
02/07/2021,PAY,CLUB LLOYDS FEE,3,,1815.96
02/07/2021,DEB,AMZNMktplace,14.99,,1818.96
02/07/2021,DEB,31K,12,,1833.95
01/07/2021,,INTEREST (GROSS),,0.63,1845.95
01/07/2021,FPO,ALICJA ALEXANDER,30,,1845.32
01/07/2021,FPO,ANTIGONI ABRAHMS,6,,1875.32
01/07/2021,FPO,TRADING212UK,500,,1881.32
01/07/2021,DD,BARCLAYS UK MTGES,981.71,,2381.32
01/07/2021,DD,NOTTM CITY COUNC,157,,3363.03
01/07/2021,DD,OCTOPUS ENERGY,90,,3520.03
01/07/2021,DD,SEVERN TRENT WATER,35.22,,3610.03
01/07/2021,SO,Q WANG,,1000,3645.25
01/07/2021,SO,ESAVINGS ACCOUNT,300,,2645.25
01/07/2021,BP,SAVE THE CHANGE,0.31,,2945.25
30/06/2021,DEB,LIDL GB NOTTINGHAM,10.69,,2945.56
29/06/2021,FPO,TRADING212UK,1100,,2956.25
29/06/2021,BP,SAVE THE CHANGE,0.12,,4056.25
29/06/2021,BGC,UNIV OF NOTTINGHAM,,3756.18,4056.37
28/06/2021,DEB,Amazon.co.uk*200PY,29.99,,300.19
28/06/2021,DEB,LIDL GB  NOTTINGHA,14.89,,330.18
28/06/2021,FPO,JOE SPENCE,26,,345.07
28/06/2021,BP,SAVE THE CHANGE,2.14,,371.07
28/06/2021,DEB,ORIENTAL MART HYDR,11.21,,373.21
28/06/2021,DEB,AMZNMktplace,7.49,,384.42
28/06/2021,FPO,ROBERT RECORD,120,,391.91
28/06/2021,DEB,AMZNMktplace,39.98,,511.91
25/06/2021,DEB,STARBUCKS,8.18,,551.89
25/06/2021,DD,TALKTALK LIMITED,21.95,,560.07
25/06/2021,BP,SAVE THE CHANGE,1.37,,582.02
24/06/2021,FPO,ANTIGONI ABRAHMS,6,,583.39
24/06/2021,DEB,Amazon.co.uk*284VM,39.99,,589.39
24/06/2021,DEB,LIDL GB  NOTTINGHA,15.06,,629.38
24/06/2021,DEB,AMZNMktplace,9.59,,644.44
24/06/2021,DEB,Audible UK,7.99,,654.03
24/06/2021,FPO,TRADING212UK,300,,662.02
24/06/2021,FPI,ABAYOMI ADAMS,,400,962.02
24/06/2021,BP,SAVE THE CHANGE,1.08,,562.02
23/06/2021,DEB,AMZNMktplace,22.33,,563.1
23/06/2021,DEB,STARBUCKS,4.59,,585.43
23/06/2021,FPO,TRADING212UK,100,,590.02
23/06/2021,FPO,RAC ELECTRICAL CON,150,,690.02
23/06/2021,BP,SAVE THE CHANGE,1.02,,840.02
22/06/2021,DEB,AMZNMktplace,40.08,,841.04
22/06/2021,DEB,AMZNMktplace,11.9,,881.12
22/06/2021,BP,SAVE THE CHANGE,0.49,,893.02
21/06/2021,DEB,AMZNMktplace,9.99,,893.51
21/06/2021,DEB,LIDL GB  NOTTINGHA,9.52,,903.5
21/06/2021,FPO,TRADING212UK,200,,913.02
21/06/2021,BP,SAVE THE CHANGE,2.95,,1113.02
21/06/2021,FPI,SHEILA SMITH,,380,1115.97
21/06/2021,DEB,AMZNMktplace,21.89,,735.97
21/06/2021,DEB,AMZNMktplace,19.95,,757.86
21/06/2021,DEB,ORIENTAL MART HYDR,10.37,,777.81
21/06/2021,DEB,DOUGHNOTTS BAKERY,5.5,,788.18
21/06/2021,DEB,WILKO RETAIL LIMIT,2.5,,793.68
21/06/2021,DEB,LIDL GB NOTTINGHAM,8.25,,796.18
21/06/2021,DEB,STARBUCKS,4.59,,804.43
18/06/2021,DEB,YOLK.,12,,809.02
18/06/2021,BP,SAVE THE CHANGE,0.3,,821.02
17/06/2021,FPO,ALICJA ALEXANDER,30,,821.32
17/06/2021,FPO,ANTIGONI ABRAHMS,6,,851.32
17/06/2021,DEB,AMZNMktplace,13.99,,857.32
17/06/2021,DEB,LIDL GB  NOTTINGHA,6.71,,871.31
17/06/2021,DD,VIRGIN MEDIA PYMTS,25.5,,878.02
17/06/2021,BP,SAVE THE CHANGE,0.66,,903.52
16/06/2021,DEB,AMZNMktplace,160.76,,904.18
16/06/2021,DEB,AMZNMKTPLACE AMAZO,21.99,,1064.94
16/06/2021,DEB,STARBUCKS,4.59,,1086.93
16/06/2021,DD,O2,19.86,,1091.52
16/06/2021,BP,SAVE THE CHANGE,1.87,,1111.38
15/06/2021,DEB,AMZNMktplace,33,,1113.25
15/06/2021,DEB,SHARIF AND SONS SU,26.82,,1146.25
15/06/2021,DEB,SOLO GRANO,16.01,,1173.07
15/06/2021,DEB,AMZNMktplace,4.79,,1189.08
15/06/2021,DEB,AMZNMktplace,3.51,,1193.87
15/06/2021,FPO,STEWART SCHOFIELD,150,,1197.38
15/06/2021,BP,SAVE THE CHANGE,0.73,,1347.38
14/06/2021,DEB,LIDL GB  NOTTINGHA,14.79,,1348.11
14/06/2021,DEB,HPI INSTANT INK UK,4.49,,1362.9
14/06/2021,DEB,ZARA NOTTINGHAM,19.99,,1367.39
14/06/2021,BP,SAVE THE CHANGE,2.04,,1387.38
14/06/2021,DEB,ORIENTAL MART HYDR,11.17,,1389.42
14/06/2021,DEB,DOUGHNOTTS BAKERY,6.5,,1400.59
14/06/2021,FPO,TRADING212UK,200,,1407.09
14/06/2021,DEB,ECOTRICITY,139.51,,1607.09
14/06/2021,DEB,SAINSBURYS S/MKTS,37.78,,1746.6
11/06/2021,FPI,SHEILA SMITH,,400,1784.38
11/06/2021,BP,SAVE THE CHANGE,1.13,,1384.38
10/06/2021,FPO,ANTIGONI ABRAHMS,6,,1385.51
10/06/2021,DEB,AMZNMktplace,77.7,,1391.51
10/06/2021,DEB,LIDL GB  NOTTINGHA,12.17,,1469.21
10/06/2021,BP,SAVE THE CHANGE,1.81,,1481.38
09/06/2021,DEB,AMZNMktplace,43.93,,1483.19
09/06/2021,DEB,STARBUCKS CAFE,7.18,,1527.12
09/06/2021,DEB,SEVERN TRENT WATER,6.34,,1534.3
09/06/2021,DEB,AMZNMKTPLACE AMAZO,31.74,,1540.64
08/06/2021,BP,SAVE THE CHANGE,0.01,,1572.38
07/06/2021,DEB,PureGym Limited,19.99,,1572.39
07/06/2021,BP,SAVE THE CHANGE,0.93,,1592.38
07/06/2021,DEB,T K MAXX,16.99,,1593.31
07/06/2021,DEB,ORIENTAL MART HYDR,9.8,,1610.3
07/06/2021,DEB,DOUGHNOTTS BAKERY,6.5,,1620.1
07/06/2021,DEB,LIDL GB  NOTTINGHA,8.78,,1626.6
04/06/2021,DEP,CLUB LLOYDS WAIVED,,3,1635.38
04/06/2021,PAY,CLUB LLOYDS FEE,3,,1632.38
04/06/2021,FPO,ROBERT RECORD,30,,1635.38
04/06/2021,BP,SAVE THE CHANGE,0.16,,1665.38
03/06/2021,DEB,LIDL GB  NOTTINGHA,14.84,,1665.54
03/06/2021,FPO,ALICJA ALEXANDER,30,,1680.38
02/06/2021,BP,SAVE THE CHANGE,0.5,,1710.38
01/06/2021,,INTEREST (GROSS),,0.62,1710.88
01/06/2021,FPO,TAMBA TAM,10,,1710.26
01/06/2021,DEB,Lush UK,20,,1720.26
01/06/2021,DEB,SUMMERS IN TIME DA,6,,1740.26
01/06/2021,DEB,PIZZAMISU,18.5,,1746.26
01/06/2021,FPO,TRADING212UK,500,,1764.76
01/06/2021,DD,BARCLAYS UK MTGES,981.71,,2264.76
01/06/2021,DD,NOTTM CITY COUNC,157,,3246.47
01/06/2021,DD,OCTOPUS ENERGY,90,,3403.47
01/06/2021,SO,Q WANG,,1000,3493.47
01/06/2021,SO,ESAVINGS ACCOUNT,300,,2493.47
01/06/2021,BP,SAVE THE CHANGE,3.27,,2793.47
01/06/2021,DEB,LIDL GB  NOTTINGHA,12.24,,2796.74
01/06/2021,DEB,AMZNMktplace,8.68,,2808.98
01/06/2021,DEB,ORIENTAL MART HYDR,20.19,,2817.66
01/06/2021,DEB,WILKO RETAIL LIMIT,9,,2837.85
01/06/2021,DEB,DOUGHNOTTS BAKERY,6.5,,2846.85
01/06/2021,DEB,GREGGS PLC,2,,2853.35
01/06/2021,TFR,R LAWRENCE  29MAY21,,900,2855.35
01/06/2021,FPO,STEWART SCHOFIELD,850,,1955.35
01/06/2021,DEB,AMZNMktplace,13.99,,2805.35
01/06/2021,DEB,AMZNMktplace,11.18,,2819.34
28/05/2021,DEB,AMZNMktplace,79.95,,2830.52
28/05/2021,DEB,SUMMERS IN TIME DA,6,,2910.47
28/05/2021,DD,TALKTALK LIMITED,21.95,,2916.47
28/05/2021,BP,SAVE THE CHANGE,0.68,,2938.42
27/05/2021,DEB,IZ *Nottingham Bik,50,,2939.1
27/05/2021,DEB,LIDL GB  NOTTINGHA,10.32,,2989.1
27/05/2021,FPO,TRADING212UK,1300,,2999.42
27/05/2021,BP,SAVE THE CHANGE,1.22,,4299.42
27/05/2021,BGC,UNIV OF NOTTINGHAM,,3756.18,4300.64
26/05/2021,DEB,AMZNMktplace,8.9,,544.46
26/05/2021,DEB,AMZNMktplace,8.03,,553.36
26/05/2021,DEB,LIDL GB  NOTTINGHA,5.85,,561.39
26/05/2021,BP,SAVE THE CHANGE,0.01,,567.24
25/05/2021,FPO,TAMBA TAM,10,,567.25
25/05/2021,DEB,AMZNMktplace,27.99,,577.25
25/05/2021,BP,SAVE THE CHANGE,0.01,,605.24
24/05/2021,DEB,Audible UK,7.99,,605.25
24/05/2021,FPO,TRADING212UK,400,,613.24
24/05/2021,FPI,ABAYOMI ADAMS,,400,1013.24
24/05/2021,BP,SAVE THE CHANGE,2.94,,613.24
24/05/2021,DEB,LIDL GB  NOTTINGHA,13.59,,616.18
24/05/2021,DEB,DOUGHNOTTS BAKERY,6.5,,629.77
24/05/2021,DEB,ORIENTAL MART HYDR,5.03,,636.27
24/05/2021,DEB,WILKO RETAIL LIMIT,2.5,,641.3
21/05/2021,DEB,LIDL GB  NOTTINGHA,8.44,,643.8
20/05/2021,FPO,TRADING212UK,100,,652.24
20/05/2021,FPO,ALICJA ALEXANDER,30,,752.24
20/05/2021,BP,SAVE THE CHANGE,0.87,,782.24
19/05/2021,DEB,AMZNMktplace,15.99,,783.11
19/05/2021,DEB,AMAZON.CO.UK*MK3GT,10.14,,799.1
19/05/2021,BP,SAVE THE CHANGE,0.32,,809.24
18/05/2021,FPO,TAMBA TAM,10,,809.56
18/05/2021,DEB,LIDL GB  NOTTINGHA,15.68,,819.56
18/05/2021,DEB,SUMMERS IN TIME DA,6,,835.24
18/05/2021,CPT,LNK NOTTINGHAM UNI,40,,841.24
17/05/2021,DD,VIRGIN MEDIA PYMTS,25.5,,881.24
17/05/2021,DD,O2,16.66,,906.74
17/05/2021,BP,SAVE THE CHANGE,1.56,,923.4
17/05/2021,DEB,ORIENTAL MART HYDR,9.77,,924.96
17/05/2021,DEB,LIDL GB  NOTTINGHA,5.27,,934.73
14/05/2021,DEB,AMZNMktplace,39.99,,940
14/05/2021,DEB,LIDL GB  NOTTINGHA,16.93,,979.99
14/05/2021,DEB,HPI INSTANT INK UK,3.49,,996.92
14/05/2021,DEB,AMAZON.CO.UK*MK65X,9.99,,1000.41
14/05/2021,DEB,SKYPE.COM/GO/BILL,5,,1010.4
14/05/2021,BP,SAVE THE CHANGE,0.13,,1015.4
13/05/2021,DEB,AMZNMktplace,2.87,,1015.53
13/05/2021,BP,SAVE THE CHANGE,0.66,,1018.4
12/05/2021,DEB,LIDL GB  NOTTINGHA,18.34,,1019.06
12/05/2021,BP,SAVE THE CHANGE,0.01,,1037.4
11/05/2021,FPO,ROBERT RECORD,105,,1037.41
11/05/2021,DEB,AMZNMktplace,9.99,,1142.41
11/05/2021,FPO,PATRICIA A S LAW,300,,1152.4
11/05/2021,BP,SAVE THE CHANGE,0.1,,1452.4
10/05/2021,DEB,AMZNMktplace,13.99,,1452.5
10/05/2021,DEB,SOLO GRANO,3.91,,1466.49
10/05/2021,BP,SAVE THE CHANGE,4.27,,1470.4
10/05/2021,DEB,ORIENTAL MART HYDR,10.34,,1474.67
10/05/2021,DEB,T K MAXX,8.97,,1485.01
10/05/2021,DEB,Amazon.co.uk*MK585,6.49,,1493.98
10/05/2021,DEB,PP*DOUGHNOTTS,6,,1500.47
10/05/2021,FPO,ANTIGONI ABRAHMS,5,,1506.47
10/05/2021,DEB,SHARIF AND SONS SU,7.29,,1511.47
10/05/2021,DEB,AMZNMktplace,3.03,,1518.76
07/05/2021,DEB,LIDL GB  NOTTINGHA,11.12,,1521.79
07/05/2021,DEB,AMZNMktplace,2.49,,1532.91
07/05/2021,DD,OCTOPUS ENERGY,90,,1535.4
07/05/2021,BP,SAVE THE CHANGE,1.24,,1625.4
06/05/2021,FPO,ALICJA ALEXANDER,30,,1626.64
06/05/2021,DEB,CLASSIC DOORS AND,78,,1656.64
06/05/2021,DEB,Amazon.co.uk*MK78E,17.58,,1734.64
06/05/2021,DEB,LIDL GB  NOTTINGHA,11.18,,1752.22
06/05/2021,BP,SAVE THE CHANGE,0.97,,1763.4
05/05/2021,DEP,CLUB LLOYDS WAIVED,,3,1764.37
05/05/2021,PAY,CLUB LLOYDS FEE,3,,1761.37
05/05/2021,DEB,AMZNMktplace,29.95,,1764.37
05/05/2021,DEB,AMZNMktplace,15.99,,1794.32
05/05/2021,DEB,AMAZON.CO.UK*MK9J0,15.09,,1810.31
05/05/2021,DEB,Amazon.co.uk*MK602,6,,1825.4
05/05/2021,BP,SAVE THE CHANGE,0.2,,1831.4
04/05/2021,,INTEREST (GROSS),,0.74,1831.6
04/05/2021,DEB,CAFFE NERO 650 NOT,2.8,,1830.86
04/05/2021,FPO,TRADING212UK,600,,1833.66
04/05/2021,TFR,R LAWRENCE,,200,2433.66
04/05/2021,DD,BARCLAYS UK MTGES,981.71,,2233.66
04/05/2021,DD,NOTTM CITY COUNC,155.06,,3215.37
04/05/2021,SO,Q WANG,,1000,3370.43
04/05/2021,SO,ESAVINGS ACCOUNT,300,,2370.43
04/05/2021,BP,SAVE THE CHANGE,2.23,,2670.43
04/05/2021,DEB,PP*DOUGHNOTTS,6.5,,2672.66
04/05/2021,FPO,ROBERT RECORD,45,,2679.16
04/05/2021,DEB,ORIENTAL MART HYDR,14.25,,2724.16
04/05/2021,DEB,WILKO RETAIL LIMIT,6,,2738.41
04/05/2021,DEB,SOLO GRANO,3.47,,2744.41
04/05/2021,DEB,LIDL GB  NOTTINGHA,12.88,,2747.88
04/05/2021,DEB,AMZNMKTPLACE AMAZO,5.67,,2760.76
04/05/2021,FPO,ANTIGONI ABRAHMS,5,,2766.43
30/04/2021,DEB,AMAZON.CO.UK*MK74Z,3,,2771.43
30/04/2021,BP,SAVE THE CHANGE,1.51,,2774.43
29/04/2021,DEB,ECOTRICITY,130.61,,2775.94
29/04/2021,DEB,LIDL GB  NOTTINGHA,12.19,,2906.55
29/04/2021,DEB,AMZNMKTPLACE AMAZO,2.69,,2918.74
29/04/2021,FPO,TRADING212UK,1000,,2921.43
29/04/2021,FPO,TRADING212UK,293,,3921.43
29/04/2021,BGC,UNIV OF NOTTINGHAM,,3756.59,4214.43
28/04/2021,FPO,TRADING212UK,100,,457.84
28/04/2021,FPO,MR IAN ELLIS,110,,557.84
28/04/2021,BP,SAVE THE CHANGE,0.35,,667.84
27/04/2021,DEB,SHARIF AND SONS SU,19.65,,668.19
27/04/2021,DD,TALKTALK LIMITED,21.95,,687.84
26/04/2021,FPO,TRADING212UK,200,,709.79
26/04/2021,BP,SAVE THE CHANGE,3.67,,909.79
26/04/2021,DEB,EAST MIDS RAILWAY,19.4,,913.46
26/04/2021,DEB,LIDL GB  NOTTINGHA,9.3,,932.86
26/04/2021,DEB,AMZNMktplace,14.99,,942.16
26/04/2021,DEB,Amazon.co.uk*M40A6,10.81,,957.15
26/04/2021,DEB,Audible UK,7.99,,967.96
26/04/2021,DEB,AMZNMktplace,3.22,,975.95
26/04/2021,DEB,AMZNMKTPLACE AMAZO,4.48,,979.17
26/04/2021,FPI,ABAYOMI ADAMS,,400,983.65
23/04/2021,DEB,AMZNMktplace,100.8,,583.65
23/04/2021,DEB,SAINSBURYS S/MKT,38.79,,684.45
23/04/2021,DEB,AMAZON.CO.UK*M44AQ,26.55,,723.24
23/04/2021,BGC,GOOGLE IRELAND,,61.27,749.79
22/04/2021,FPO,TRADING212UK,200,,688.52
22/04/2021,FPI,MARK NEAL WINSTEIN,,395.51,888.52
22/04/2021,BP,SAVE THE CHANGE,0.73,,493.01
21/04/2021,DEB,LIDL GB  NOTTINGHA,15.27,,493.74
20/04/2021,FPO,ALICJA ALEXANDER,25,,509.01
20/04/2021,BP,SAVE THE CHANGE,0.51,,534.01
19/04/2021,DEB,AMZNMktplace,6.99,,534.52
19/04/2021,DEB,PP*DOUGHNOTTS,6.5,,541.51
19/04/2021,DD,VIRGIN MEDIA PYMTS,25.5,,548.01
19/04/2021,BP,SAVE THE CHANGE,1.06,,573.51
19/04/2021,DEB,T K MAXX,41.96,,574.57
19/04/2021,DEB,ORIENTAL MART HYDR,7.48,,616.53
19/04/2021,DEB,WILKO RETAIL LIMIT,4.5,,624.01
19/04/2021,FPO,ANTIGONI ABRAHMS,5,,628.51
16/04/2021,DD,O2,16.66,,633.51
16/04/2021,BP,SAVE THE CHANGE,0.91,,650.17
15/04/2021,DEB,AMAZON.CO.UK*M46EG,69.09,,651.08
15/04/2021,BP,SAVE THE CHANGE,0.7,,720.17
14/04/2021,DEB,LIDL GB  NOTTINGHA,16.3,,720.87
14/04/2021,FPO,MR IAN ELLIS,255,,737.17
14/04/2021,BP,SAVE THE CHANGE,0.51,,992.17
13/04/2021,DEB,HPI INSTANT INK UK,3.49,,992.68
13/04/2021,BP,SAVE THE CHANGE,1.6,,996.17
12/04/2021,DEB,SOLO GRANO,3.05,,997.77
12/04/2021,DEB,TESCO STORES 5954,2,,1000.82
12/04/2021,DEB,CAFFE NERO 650 NOT,3.35,,1002.82
12/04/2021,BP,SAVE THE CHANGE,1.35,,1006.17
12/04/2021,DEB,ORIENTAL MART HYDR,13.91,,1007.52
12/04/2021,DEB,TESCO STORE 2960,10.09,,1021.43
12/04/2021,DEB,WWW.DOUGHN* DOUGHN,6.8,,1031.52
12/04/2021,FPO,ANTIGONI ABRAHMS,5,,1038.32
12/04/2021,DEB,ECOTRICITY,500,,1043.32
12/04/2021,DEB,AMZNMktplace,43.99,,1543.32
09/04/2021,DEB,LIDL GB  NOTTINGHA,10.86,,1587.31
09/04/2021,BP,SAVE THE CHANGE,0.01,,1598.17
08/04/2021,DEB,AMZNMktplace,6,,1598.18
08/04/2021,DEB,AMZNMKTPLACE AMAZO,7.99,,1604.18
08/04/2021,BP,SAVE THE CHANGE,0.2,,1612.17
07/04/2021,FPO,ALICJA ALEXANDER,25,,1612.37
07/04/2021,DEB,LIDL GB  NOTTINGHA,18.8,,1637.37
07/04/2021,BP,SAVE THE CHANGE,0.08,,1656.17
06/04/2021,DEP,CLUB LLOYDS WAIVED,,3,1656.25
06/04/2021,PAY,CLUB LLOYDS FEE,3,,1653.25
06/04/2021,DEB,AMZNMktplace,107.95,,1656.25
06/04/2021,DEB,AMZNMktplace,24.98,,1764.2
06/04/2021,DEB,AMZNMktplace,19.99,,1789.18
06/04/2021,FPO,TRADING212UK,500,,1809.17
06/04/2021,BP,SAVE THE CHANGE,3.44,,2309.17
06/04/2021,DEB,SOLO GRANO,5.7,,2312.61
06/04/2021,DEB,SOLO GRANO,3.36,,2318.31
06/04/2021,FPI,MIAH MA,,98.5,2321.67
06/04/2021,DEB,ORIENTAL MART HYDR,12.19,,2223.17
06/04/2021,DEB,WWW.DOUGHN* DOUGHN,6.8,,2235.36
06/04/2021,DEB,WILKO RETAIL LIMIT,3.25,,2242.16
06/04/2021,FPO,ANTIGONI ABRAHMS,5,,2245.41
06/04/2021,DEB,AMZNMktplace,16.99,,2250.41
06/04/2021,DEB,LIDL GB  NOTTINGHA,16.74,,2267.4
06/04/2021,DEB,AMZNMktplace,8.59,,2284.14
06/04/2021,DEB,AMAZON.CO.UK*MU384,6,,2292.73
06/04/2021,FPO,MR IAN ELLIS,140,,2298.73
06/04/2021,DEB,AMZNMktplace,17.99,,2438.73
01/04/2021,,INTEREST (GROSS),,0.48,2456.72
01/04/2021,DEB,AMZNMktplace,58.96,,2456.24
01/04/2021,DEB,AMZNMktplace,8.99,,2515.2
01/04/2021,DD,BARCLAYS UK MTGES,981.71,,2524.19
01/04/2021,SO,Q WANG,,1000,3505.9
01/04/2021,SO,ESAVINGS ACCOUNT,300,,2505.9
01/04/2021,BP,SAVE THE CHANGE,0.19,,2805.9
31/03/2021,DEB,AMZNMktplace,16.99,,2806.09
31/03/2021,DEB,LIDL GB  NOTTINGHA,6.82,,2823.08
31/03/2021,DEB,AMZ*hzmizimi,,16.99,2829.9
31/03/2021,BP,SAVE THE CHANGE,0.23,,2812.91
30/03/2021,DEB,SHARIF AND SONS SU,13.77,,2813.14
30/03/2021,FPO,TRADING212UK,1000,,2826.91
30/03/2021,BP,SAVE THE CHANGE,0.95,,3826.91
30/03/2021,BGC,UNIV OF NOTTINGHAM,,3665.25,3827.86
29/03/2021,DEB,SOLO GRANO,8.05,,162.61
29/03/2021,BP,SAVE THE CHANGE,1.09,,170.66
29/03/2021,DEB,ORIENTAL MART HYDR,12.89,,171.75
29/03/2021,DEB,WAITROSE 833,10.23,,184.64
29/03/2021,DEB,WWW.DOUGHN* DOUGHN,6.8,,194.87
29/03/2021,FPO,ANTIGONI ABRAHMS,5,,201.67
29/03/2021,DEB,AMZNMktplace,16.99,,206.67
26/03/2021,DD,TALKTALK LIMITED,19.95,,223.66
26/03/2021,BP,SAVE THE CHANGE,0.6,,243.61
25/03/2021,DEB,AMZNMktplace,16.99,,244.21
25/03/2021,DEB,LIDL GB  NOTTINGHA,4.41,,261.2
25/03/2021,FPO,TRADING212UK,200,,265.61
25/03/2021,FPI,YEWANDE MARIAN ADE,,400,465.61
25/03/2021,BP,SAVE THE CHANGE,0.02,,65.61
24/03/2021,DEB,IKEA LTD SHOP ONLI,320,,65.63
24/03/2021,DEB,AMZNMKTPLACE AMAZO,74.99,,385.63
24/03/2021,DEB,Audible UK,7.99,,460.62
24/03/2021,TFR,R LAWRENCE,,50,468.61
23/03/2021,DEB,LIDL GB  NOTTINGHA,11.1,,418.61
23/03/2021,FPO,ALICJA ALEXANDER,25,,429.71
23/03/2021,BP,SAVE THE CHANGE,0.71,,454.71
22/03/2021,DEB,ORIENTAL MART HYDR,22.49,,455.42
22/03/2021,DEB,WWW.DOUGHN* DOUGHN,6.8,,477.91
22/03/2021,DEB,UBER   *TRIP,2,,484.71
22/03/2021,BP,SAVE THE CHANGE,1.07,,486.71
22/03/2021,DEB,UBER *TRIP HELP.UB,13.66,,487.78
22/03/2021,FPO,ANTIGONI ABRAHMS,5,,501.44
22/03/2021,DEB,Audible UK,18,,506.44
22/03/2021,DEB,LIDL GB  NOTTINGHA,17.28,,524.44
19/03/2021,FPO,TRADING212UK,100,,541.72
19/03/2021,DEB,AMZNMktplace,6.99,,641.72
19/03/2021,BP,SAVE THE CHANGE,0.26,,648.71
18/03/2021,DEB,TESCO STORES 5368,3.74,,648.97
18/03/2021,BP,SAVE THE CHANGE,0.5,,652.71
17/03/2021,DEB,LIDL GB  NOTTINGHA,5.87,,653.21
17/03/2021,DEB,AMZNMktplace,3.63,,659.08
17/03/2021,DD,VIRGIN MEDIA PYMTS,25.5,,662.71
17/03/2021,BP,SAVE THE CHANGE,0.8,,688.21
16/03/2021,DEB,AMZNMKTPLACE AMAZO,18.2,,689.01
16/03/2021,DD,O2,16.44,,707.21
16/03/2021,BP,SAVE THE CHANGE,1.35,,723.65
15/03/2021,DEB,SOLO GRANO,9.25,,725
15/03/2021,DEB,AMZNMKTPLACE AMAZO,6.4,,734.25
15/03/2021,BP,SAVE THE CHANGE,1.7,,740.65
15/03/2021,DEB,ORIENTAL MART HYDR,13.02,,742.35
15/03/2021,DEB,WWW.DOUGHNOTTSOFFI,6.8,,755.37
15/03/2021,DEB,HPI INSTANT INK UK,7.49,,762.17
12/03/2021,DEB,Amazon.co.uk*MM61F,186.99,,769.66
12/03/2021,BP,SAVE THE CHANGE,1,,956.65
11/03/2021,DEB,AMZNMktplace,5.14,,957.65
11/03/2021,DEB,AMZNMKTPLACE AMAZO,42.86,,962.79
10/03/2021,FPO,ALICJA ALEXANDER,25,,1005.65
10/03/2021,BP,SAVE THE CHANGE,0.84,,1030.65
09/03/2021,DEB,Amazon Prime*MM728,79,,1031.49
09/03/2021,DEB,AMZNMktplace,19.92,,1110.49
09/03/2021,DEB,LIDL GB  NOTTINGHA,10.24,,1130.41
09/03/2021,BP,SAVE THE CHANGE,0.06,,1140.65
08/03/2021,DEB,ORIENTAL MART HYDR,13.94,,1140.71
08/03/2021,FPO,KYLE MCDERMOTT,208.8,,1154.65
08/03/2021,BP,SAVE THE CHANGE,1.53,,1363.45
08/03/2021,DEB,WWW.DOUGHNOTTSOFFI,6.8,,1364.98
08/03/2021,DEB,TESCO STORE 2960,2,,1371.78
08/03/2021,FPO,ANTIGONI ABRAHMS,5,,1373.78
08/03/2021,DEB,Amazon.co.uk*MM82L,28.66,,1378.78
05/03/2021,FPO,ROBERT RECORD,100,,1407.44
05/03/2021,DEB,Amazon.co.uk*MM0OR,29.99,,1507.44
05/03/2021,DEB,LIDL GB  NOTTINGHA,7.02,,1537.43
04/03/2021,BP,SAVE THE CHANGE,0.75,,1544.45
03/03/2021,DEB,SAINSBURYS S/MKT,22.25,,1545.2
03/03/2021,BP,SAVE THE CHANGE,1.27,,1567.45
02/03/2021,DEP,CLUB LLOYDS WAIVED,,3,1568.72
02/03/2021,PAY,CLUB LLOYDS FEE,3,,1565.72
02/03/2021,DEB,LIDL GB  NOTTINGHA,9.24,,1568.72
02/03/2021,DEB,AMAZON.CO.UK*MM4J6,28.49,,1577.96
02/03/2021,FPI,IISL CLIENT GBP SE,,17.77,1606.45
02/03/2021,FPI,IISL CLIENT GBP SE,,15.19,1588.68
02/03/2021,BP,SAVE THE CHANGE,0.45,,1573.49
01/03/2021,,INTEREST (GROSS),,0.57,1573.94
01/03/2021,DEB,TESCO STORES 6735,4.55,,1573.37
01/03/2021,FPO,TRADING212UK,500,,1577.92
01/03/2021,DD,BARCLAYS UK MTGES,981.71,,2077.92
01/03/2021,SO,Q WANG,,1000,3059.63
01/03/2021,SO,ESAVINGS ACCOUNT,300,,2059.63
01/03/2021,BP,SAVE THE CHANGE,1.65,,2359.63
01/03/2021,DEB,ORIENTAL MART HYDR,14.31,,2361.28
01/03/2021,DEB,WWW.DOUGHNOTTSOFFI,6.8,,2375.59
01/03/2021,FPO,ANTIGONI ABRAHMS,5,,2382.39
26/02/2021,DEB,CARPETRIGHT,497.48,,2387.39
26/02/2021,DEB,AMZNMktplace,42.97,,2884.87
26/02/2021,DEB,LIDL GB  NOTTINGHA,5.79,,2927.84
26/02/2021,DD,TALKTALK LIMITED,19.95,,2933.63
26/02/2021,BP,SAVE THE CHANGE,0.65,,2953.58
25/02/2021,DEB,Trading212UK,201.4,,2954.23
25/02/2021,DEB,WILKO RETAIL LIMIT,13.95,,3155.63
25/02/2021,FPO,TRADING212UK,1000,,3169.58
25/02/2021,BP,SAVE THE CHANGE,0.01,,4169.58
25/02/2021,BGC,UNIV OF NOTTINGHAM,,3665.25,4169.59
24/02/2021,DEB,CLASSIC DOORS AND,264,,504.34
24/02/2021,DEB,Audible UK,7.99,,768.34
24/02/2021,BP,SAVE THE CHANGE,1.47,,776.33
23/02/2021,DEB,LIDL GB  NOTTINGHA,6.11,,777.8
23/02/2021,DEB,LIDL GB  NOTTINGHA,4.42,,783.91
23/02/2021,FPI,YEWANDE MARIAN ADE,,400,788.33
23/02/2021,TFR,R LAWRENCE,,100,388.33
23/02/2021,FPO,ALICJA ALEXANDER,25,,288.33
23/02/2021,BP,SAVE THE CHANGE,1.05,,313.33
22/02/2021,DEB,AMZNMktplace,15.9,,314.38
22/02/2021,DEB,SOLO GRANO,9.05,,330.28
22/02/2021,BP,SAVE THE CHANGE,2.99,,339.33
22/02/2021,DEB,ORIENTAL MART HYDR,19.16,,342.32
22/02/2021,DEB,WWW.DOUGHNOTTSOFFI,10.05,,361.48
22/02/2021,DEB,WWW.DOUGHNOTTSOFFI,3.55,,371.53
22/02/2021,DEB,PRET A MANGER,2.99,,375.08
22/02/2021,FPO,ANTIGONI ABRAHMS,5,,378.07
22/02/2021,DEB,LIDL GB  NOTTINGHA,8.26,,383.07
19/02/2021,FPO,ANTONY GRICE (PLUM,93.6,,391.33
19/02/2021,FPI,IISL CLIENT GBP SE,,43.51,484.93
18/02/2021,BP,SAVE THE CHANGE,0.77,,441.42
17/02/2021,DEB,SHARIF AND SONS SU,18.23,,442.19
17/02/2021,DD,VIRGIN MEDIA PYMTS,25.5,,460.42
17/02/2021,BP,SAVE THE CHANGE,0.01,,485.92
16/02/2021,DEB,SHARIF AND SONS SU,40.99,,485.93
16/02/2021,DD,O2,16.44,,526.92
16/02/2021,BP,SAVE THE CHANGE,1.66,,543.36
15/02/2021,DEB,AMZNMktplace,23.69,,545.02
15/02/2021,DEB,TESCO STORE 2960,5.5,,568.71
15/02/2021,DEB,SOLO GRANO,3.15,,574.21
15/02/2021,BP,SAVE THE CHANGE,5.43,,577.36
15/02/2021,DEB,ORIENTAL MART HYDR,18.88,,582.79
15/02/2021,DEB,WWW.DOUGHNOTTSOFFI,10.05,,601.67
15/02/2021,DEB,AMZNMKTPLACE AMAZO,3.21,,611.72
15/02/2021,DEB,HPI INSTANT INK UK,6.49,,614.93
15/02/2021,FPO,ANTIGONI ABRAHMS,5,,621.42
15/02/2021,DEB,Trading212UK,151.05,,626.42
15/02/2021,DEB,Trading212UK,151.05,,777.47
15/02/2021,DEB,CLASSIC DOORS AND,66,,928.52
15/02/2021,DEB,V Spot,33.72,,994.52
12/02/2021,DEB,Amazon.co.uk*MF1LV,15.12,,1028.24
12/02/2021,DEB,APOLLO BLINDS,415,,1043.36
11/02/2021,DEB,ADI PRO LEAK LTD,594,,1458.36
11/02/2021,FPI,S.H.S.,,240,2052.36
10/02/2021,TFR,R LAWRENCE,,500,1812.36
10/02/2021,BP,SAVE THE CHANGE,0.21,,1312.36
09/02/2021,FPO,ALICJA ALEXANDER,25,,1312.57
09/02/2021,DEB,LIDL GB  NOTTINGHA,7.79,,1337.57
09/02/2021,BP,SAVE THE CHANGE,0.97,,1345.36
08/02/2021,DEB,LIDL GB  NOTTINGHA,12.03,,1346.33
08/02/2021,BP,SAVE THE CHANGE,1.66,,1358.36
08/02/2021,DEB,ORIENTAL MART HYDR,24.49,,1360.02
08/02/2021,DEB,AMZNMktplace,19.96,,1384.51
08/02/2021,DEB,WWW.DOUGHNOTTSOFFI,10.05,,1404.47
08/02/2021,FPO,ANTIGONI ABRAHMS,5,,1414.52
05/02/2021,DEB,Trading212UK,553.85,,1419.52
05/02/2021,DEB,AMZNMktplace,11.99,,1973.37
05/02/2021,FPI,IISL CLIENT GBP SE,,1,1985.36
04/02/2021,DEB,Trading212UK,,1,1984.36
04/02/2021,BP,SAVE THE CHANGE,0.87,,1983.36
03/02/2021,DEB,LIDL GB  NOTTINGHA,8.13,,1984.23
03/02/2021,BP,SAVE THE CHANGE,0.5,,1992.36
02/02/2021,DEP,CLUB LLOYDS WAIVED,,3,1992.86
02/02/2021,PAY,CLUB LLOYDS FEE,3,,1989.86
02/02/2021,DEB,Trading212UK,503.5,,1992.86
01/02/2021,,INTEREST (GROSS),,0.56,2496.36
01/02/2021,FPO,SHS,240,,2495.8
01/02/2021,TFR,R LAWRENCE,,128,2735.8
01/02/2021,DD,BARCLAYS UK MTGES,981.71,,2607.8
01/02/2021,SO,Q WANG,,1000,3589.51
01/02/2021,SO,ESAVINGS ACCOUNT,300,,2589.51
01/02/2021,BP,SAVE THE CHANGE,2.44,,2889.51
01/02/2021,DEB,ORIENTAL MART HYDR,18.71,,2891.95
01/02/2021,DEB,WWW.DOUGHNOTTSOFFI,10.05,,2910.66
01/02/2021,DEB,LIDL GB  NOTTINGHA,4.8,,2920.71
29/01/2021,DEB,Trading212UK,1001.4,,2925.51
29/01/2021,DEB,SAINSBURYS S/MKT,15.6,,3926.91
29/01/2021,DD,TALKTALK LIMITED,19.95,,3942.51
28/01/2021,DEB,IKEA LTD SHOP ONLI,40,,3962.46
28/01/2021,FPO,ALICJA ALEXANDER,25,,4002.46
28/01/2021,FPO,PATRICIA A S LAW,220,,4027.46
28/01/2021,BP,SAVE THE CHANGE,1.13,,4247.46
28/01/2021,BGC,UNIV OF NOTTINGHAM,,3664.85,4248.59
27/01/2021,DEB,V Spot,23.87,,583.74
27/01/2021,DEB,WILKO RETAIL LIMIT,2.5,,607.61
27/01/2021,DEB,CO-OP GROUP 010161,1.5,,610.11
27/01/2021,BP,SAVE THE CHANGE,0.06,,611.61
26/01/2021,DEB,AMZNMktplace,47.95,,611.67
26/01/2021,DEB,AMZNMktplace,13.99,,659.62
26/01/2021,BP,SAVE THE CHANGE,0.35,,673.61
25/01/2021,FPO,ROBERT RECORD,75,,673.96
25/01/2021,DEB,Trading212UK,200,,748.96
25/01/2021,DEB,TESCO STORES 5368,5.65,,948.96
25/01/2021,BP,SAVE THE CHANGE,2.94,,954.61
25/01/2021,DEB,ORIENTAL MART HYDR,26.55,,957.55
25/01/2021,DEB,Audible UK,7.99,,984.1
25/01/2021,DEB,WWW.DOUGHNOTTSOFFI,6.8,,992.09
25/01/2021,DEB,TESCO STORE 2960,5.11,,998.89
25/01/2021,DEB,IKEA LTD SHOP ONLI,,65,1004
25/01/2021,FPI,YEWANDE MARIAN ADE,,400,939
25/01/2021,DEB,LIDL GB  NOTTINGHA,13.33,,539
22/01/2021,DEB,IKEA LTD SHOP ONLI,65,,552.33
22/01/2021,DEB,Amazon.co.uk*MV5U4,6.95,,617.33
22/01/2021,DEB,Amazon.co.uk*MV7U0,5.33,,624.28
22/01/2021,BP,SAVE THE CHANGE,1.18,,629.61
21/01/2021,DEB,AMZNMktplace,60.47,,630.79
21/01/2021,DEB,AMAZON.CO.UK*MV8UG,4.6,,691.26
21/01/2021,DEB,TESCO STORES 5368,2.75,,695.86
21/01/2021,BP,SAVE THE CHANGE,0.55,,698.61
20/01/2021,DEB,TESCO STORES 5368,5.45,,699.16
20/01/2021,BP,SAVE THE CHANGE,0.24,,704.61
19/01/2021,DEB,LIDL GB  NOTTINGHA,10.76,,704.85
19/01/2021,BP,SAVE THE CHANGE,0.65,,715.61
18/01/2021,DEB,STARBUCKS,7.35,,716.26
18/01/2021,DD,VIRGIN MEDIA PYMTS,83,,723.61
18/01/2021,DD,O2,16.44,,806.61
18/01/2021,BP,SAVE THE CHANGE,0.9,,823.05
18/01/2021,DEB,ORIENTAL MART HYDR,20.11,,823.95
18/01/2021,DEB,AMZNMKTPLACE AMAZO,29.99,,844.06
18/01/2021,FPO,ANTIGONI ABRAHMS,5,,874.05
15/01/2021,DEB,Trading212UK,200,,879.05
15/01/2021,BP,SAVE THE CHANGE,0.51,,1079.05
14/01/2021,DEB,HP INC UK LIMITED,3.49,,1079.56
14/01/2021,DEB,AMAZON.CO.UK*MV3ZD,15,,1083.05
14/01/2021,FPI,YEWANDE MARIAN ADE,,400,1098.05
14/01/2021,BP,SAVE THE CHANGE,0.27,,698.05
13/01/2021,DEB,LIDL GB  NOTTINGHA,18.73,,698.32
12/01/2021,FPO,ALICJA ALEXANDER,25,,717.05
11/01/2021,BP,SAVE THE CHANGE,1.85,,742.05
11/01/2021,DEB,ORIENTAL MART HYDR,20.39,,743.9
11/01/2021,DEB,LIDL GB  NOTTINGHA,9.12,,764.29
11/01/2021,FPO,ANTIGONI ABRAHMS,5,,773.41
11/01/2021,DEB,Trading212UK,300,,778.41
11/01/2021,DEB,AMZNMktplace,19.99,,1078.41
08/01/2021,DEB,AMAZON.CO.UK*MJ513,27.65,,1098.4
08/01/2021,BP,SAVE THE CHANGE,0.5,,1126.05
07/01/2021,DEB,LIDL GB  NOTTINGHA,13.5,,1126.55
06/01/2021,FPO,MR J LITCHFIELD,370,,1140.05
06/01/2021,BP,SAVE THE CHANGE,0.49,,1510.05
05/01/2021,DEP,CLUB LLOYDS WAIVED,,3,1510.54
05/01/2021,PAY,CLUB LLOYDS FEE,3,,1507.54
05/01/2021,DEB,Trading212UK,500,,1510.54
05/01/2021,DEB,LIDL GB  NOTTINGHA,9.51,,2010.54
04/01/2021,,INTEREST (GROSS),,1.87,2020.05
04/01/2021,DD,BARCLAYS UK MTGES,981.71,,2018.18
04/01/2021,SO,Q WANG,,1000,2999.89
04/01/2021,SO,ESAVINGS ACCOUNT,300,,1999.89
04/01/2021,BP,SAVE THE CHANGE,0.15,,2299.89
04/01/2021,DEB,IKEA LTD SHOP ONLI,296,,2300.04
31/12/2020,DEB,LIDL GB  NOTTINGHA,15.85,,2596.04
31/12/2020,DD,TALKTALK LIMITED,18.64,,2611.89
31/12/2020,BP,SAVE THE CHANGE,0.67,,2630.53
30/12/2020,DEB,ORIENTAL MART HYDR,15.33,,2631.2
30/12/2020,DEB,The Body Shop,15,,2646.53
30/12/2020,BP,SAVE THE CHANGE,0.16,,2661.53
29/12/2020,FPO,SALLY GOLDSTONE,198,,2661.69
29/12/2020,DEB,AMZNMktplace,27.84,,2859.69
29/12/2020,BP,SAVE THE CHANGE,2.64,,2887.53
29/12/2020,DEB,T4 TEA SALOON,13.6,,2890.17
29/12/2020,DEB,TESCO STORES 5368,5.2,,2903.77
29/12/2020,DEB,BLUEBIRD WHOLEFOOD,32.26,,2908.97
24/12/2020,DEB,Trading212UK,250,,2941.23
24/12/2020,DEB,LIDL GB  NOTTINGHA,19.31,,3191.23
24/12/2020,DEB,Audible UK,7.99,,3210.54
24/12/2020,BP,SAVE THE CHANGE,0.05,,3218.53
23/12/2020,DEB,Trading212UK,230,,3218.58
23/12/2020,DEB,AMZNMktplace,12.95,,3448.58
23/12/2020,BP,SAVE THE CHANGE,0.48,,3461.53
22/12/2020,DEB,YANKEE STORE,9.72,,3462.01
22/12/2020,DEB,CAFFE NERO 650 NOT,5.8,,3471.73
22/12/2020,FPO,SHS,240,,3477.53
22/12/2020,FPO,MR J LITCHFIELD,682,,3717.53
22/12/2020,DD,THE RENEWABLE ENER,92.93,,4399.53
22/12/2020,BP,SAVE THE CHANGE,0.31,,4492.46
21/12/2020,DEB,AMZNMktplace,8.69,,4492.77
21/12/2020,FPO,ANTIGONI ABRAHMS,5,,4501.46
21/12/2020,BP,SAVE THE CHANGE,3.55,,4506.46
21/12/2020,DEB,ORIENTAL MART HYDR,17.27,,4510.01
21/12/2020,DEB,PP*DOUGHNOTTS,6.5,,4527.28
21/12/2020,DEB,WILKO RETAIL LIMIT,1,,4533.78
21/12/2020,DEB,Trading212UK,1000,,4534.78
21/12/2020,DEB,BLUEBIRD WHOLEFOOD,10.23,,5534.78
21/12/2020,DEB,WILKO RETAIL LIMIT,10,,5545.01
21/12/2020,DEB,OZAN INTERNATIONAL,5.35,,5555.01
18/12/2020,DEB,AMZNMKTPLACE AMAZO,8.1,,5560.36
18/12/2020,BP,SAVE THE CHANGE,0.93,,5568.46
18/12/2020,BGC,NCC TRADE CRED NEW,,32.44,5569.39
17/12/2020,DEB,AMZNMktplace,24.07,,5536.95
17/12/2020,BP,SAVE THE CHANGE,0.04,,5561.02
17/12/2020,BGC,UNIV OF NOTTINGHAM,,3665.25,5561.06
16/12/2020,DEB,AMZNMktplace,29.99,,1895.81
16/12/2020,DEB,AMZNMktplace,15.97,,1925.8
16/12/2020,DD,BARCLAYS UK MTGES,1005.95,,1941.77
16/12/2020,DD,O2,16.44,,2947.72
16/12/2020,BP,SAVE THE CHANGE,0.26,,2964.16
15/12/2020,DEB,Trading212UK,750,,2964.42
15/12/2020,DEB,LIDL GB  NOTTINGHA,8.94,,3714.42
15/12/2020,DEB,CAFFE NERO 650 NOT,3.8,,3723.36
15/12/2020,BP,SAVE THE CHANGE,0.52,,3727.16
14/12/2020,DEB,AMZNMktplace,9.99,,3727.68
14/12/2020,DEB,HP INC UK LIMITED,3.49,,3737.67
14/12/2020,BP,SAVE THE CHANGE,3.38,,3741.16
14/12/2020,BGC,DEPOSIT PROTECTION,,950,3744.54
14/12/2020,BGC,SEVERN TRENT WATER,,17.6,2794.54
14/12/2020,DEB,AMZNMKTPLACE AMAZO,15.9,,2776.94
14/12/2020,DEB,ORIENTAL MART HYDR,15.19,,2792.84
14/12/2020,DEB,PP*DOUGHNOTTS,6.5,,2808.03
14/12/2020,DEB,STARBUCKS,3.95,,2814.53
14/12/2020,DEB,AMZNMktplace,40.29,,2818.48
14/12/2020,DEB,LIDL GB  NOTTINGHA,12.29,,2858.77
14/12/2020,DEB,AMZNMktplace,5.69,,2871.06
14/12/2020,DEB,APOLLO BLINDS,200,,2876.75
11/12/2020,DEB,AMZNMktplace,2.81,,3076.75
11/12/2020,FPI,HOWELLS LEGAL LIMI,,276,3079.56
11/12/2020,BP,SAVE THE CHANGE,0.74,,2803.56
10/12/2020,FPO,ANTIGONI ABRAHMS,5,,2804.3
10/12/2020,FPO,ROBERT RECORD,310,,2809.3
10/12/2020,DEB,Trading212UK,250,,3119.3
10/12/2020,DEB,SHARIF AND SONS SU,34.26,,3369.3
10/12/2020,BP,SAVE THE CHANGE,0.19,,3403.56
09/12/2020,DEB,LIDL GB  NOTTINGHA,33.81,,3403.75
09/12/2020,DEB,THE LITTLE CARPET,,246,3437.56
09/12/2020,BP,SAVE THE CHANGE,1.16,,3191.56
08/12/2020,DEB,AMZNMktplace,62.77,,3192.72
08/12/2020,DEB,AMZNMKTPLACE AMAZO,6.07,,3255.49
07/12/2020,BP,SAVE THE CHANGE,0.98,,3261.56
07/12/2020,DEB,Trading212UK,200,,3262.54
07/12/2020,DEB,AMZNMktplace,23.98,,3462.54
04/12/2020,DEB,BLUEBIRD WHOLEFOOD,14.04,,3486.52
04/12/2020,BP,SAVE THE CHANGE,0.92,,3500.56
03/12/2020,DEB,JUBILEE SHOP,5.08,,3501.48
03/12/2020,BP,SAVE THE CHANGE,0.93,,3506.56
02/12/2020,DEP,CLUB LLOYDS WAIVED,,3,3507.49
02/12/2020,PAY,CLUB LLOYDS FEE,3,,3504.49
02/12/2020,DEB,Trading212UK,500,,3507.49
02/12/2020,DEB,LIDL GB  NOTTINGHA,12.07,,4007.49
01/12/2020,,INTEREST (GROSS),,1.48,4019.56
01/12/2020,FPI,Q WANG,,1000,4018.08
01/12/2020,DD,NOTTM CITY COUNC,119,,3018.08
01/12/2020,DD,SEVERN TRENT WATER,16.43,,3137.08
01/12/2020,SO,ESAVINGS ACCOUNT,300,,3153.51
01/12/2020,BP,SAVE THE CHANGE,0.87,,3453.51
30/11/2020,DEB,SOLO GRANO,9.13,,3454.38
30/11/2020,FPO,ALICJA ALEXANDER,40,,3463.51
30/11/2020,BP,SAVE THE CHANGE,0.78,,3503.51
30/11/2020,DEB,Trading212UK,1000,,3504.29
30/11/2020,DEB,THE BIKE SHOP,13.98,,4504.29
30/11/2020,DEB,LIDL GB NOTTINGHAM,11.24,,4518.27
30/11/2020,FPO,BORIS REMOVALS,650,,4529.51
27/11/2020,DD,TALKTALK LIMITED,19.95,,5179.51
27/11/2020,BP,SAVE THE CHANGE,0.57,,5199.46
27/11/2020,BGC,UNIV OF NOTTINGHAM,,3665.25,5200.03
26/11/2020,DEB,JUBILEE SHOP,6.43,,1534.78
26/11/2020,BP,SAVE THE CHANGE,1.98,,1541.21
25/11/2020,DEB,Trading212UK,1405,,1543.19
25/11/2020,DEB,AMZNMktplace,47.89,,2948.19
25/11/2020,DEB,Trading212UK,25,,2996.08
25/11/2020,DEB,MOGAL EXPRESS,18.06,,3021.08
25/11/2020,DEB,LIDL GB NOTTINGHAM,7.07,,3039.14
25/11/2020,BP,SAVE THE CHANGE,0.03,,3046.21
25/11/2020,BGC,GOOGLE IRELAND,,61.65,3046.24
24/11/2020,DEB,AMZNMktplace,19.98,,2984.59
24/11/2020,DEB,Audible UK,7.99,,3004.57
24/11/2020,FPI,IISL CLIENT GBP SE,,1405.69,3012.56
23/11/2020,BP,SAVE THE CHANGE,2.49,,1606.87
23/11/2020,DEB,ORIENTAL MART HYDR,10.52,,1609.36
23/11/2020,DEB,STARBUCKS,7.4,,1619.88
23/11/2020,DEB,LIDL GB NOTTINGHAM,6.42,,1627.28
23/11/2020,DEB,PP*DOUGHNOTTS,5.5,,1633.7
23/11/2020,DEB,Trading212UK,738,,1639.2
23/11/2020,DEB,CO-OP GROUP 010661,11.78,,2377.2
23/11/2020,DEB,Amazon.co.uk*M703H,6,,2388.98
23/11/2020,DEB,AMZNMKTPLACE AMAZO,45.89,,2394.98
20/11/2020,DEB,Trading212UK,106,,2440.87
20/11/2020,FPI,IISL CLIENT GBP SE,,737.35,2546.87
20/11/2020,BP,SAVE THE CHANGE,0.76,,1809.52
19/11/2020,DEB,THE LITTLE CARPET,1174,,1810.28
19/11/2020,DEB,AMZNMktplace,11.49,,2984.28
19/11/2020,DEB,AMAZON.CO.UK*M75IR,6,,2995.77
19/11/2020,DEB,ATRIUM JUBILEE 1,3.75,,3001.77
19/11/2020,FPI,IISL CLIENT GBP SE,,105.82,3005.52
19/11/2020,BP,SAVE THE CHANGE,1.35,,2899.7
18/11/2020,DEB,AMZNMktplace,31.98,,2901.05
18/11/2020,DEB,AMZNMktplace,21.09,,2933.03
18/11/2020,DEB,LIDL GB NOTTINGHAM,7.58,,2954.12
18/11/2020,FPO,ALICJA ALEXANDER,25,,2961.7
17/11/2020,DEB,Trading212UK,860,,2986.7
17/11/2020,BP,SAVE THE CHANGE,1.06,,3846.7
16/11/2020,DEB,LIDL GB NOTTINGHAM,13.49,,3847.76
16/11/2020,DEB,AMAZON.CO.UK*M7959,10.45,,3861.25
16/11/2020,FPI,IISL CLIENT GBP SE,,100,3871.7
16/11/2020,FPI,IISL CLIENT GBP SE,,760.39,3771.7
16/11/2020,DD,O2,16.63,,3011.31
16/11/2020,BP,SAVE THE CHANGE,2.85,,3027.94
16/11/2020,DEB,ORIENTAL MART HYDR,15.24,,3030.79
16/11/2020,DEB,AMZNMktplace,13.73,,3046.03
16/11/2020,DEB,HOLLAND & BARRETT,9.49,,3059.76
16/11/2020,DEB,ORIENTAL MART HYDR,0.79,,3069.25
16/11/2020,DEB,Trading212UK,1333,,3070.04
16/11/2020,DEB,Trading212UK,100,,4403.04
16/11/2020,CPT,LNK 36 CLUMBER STR,40,,4503.04
13/11/2020,DEB,POST OFFICE COUNTE,47.99,,4543.04
13/11/2020,DEB,AMZNMktplace,11.49,,4591.03
13/11/2020,DEB,Amazon.co.uk*M768X,3.42,,4602.52
13/11/2020,FPI,IISL CLIENT GBP SE,,1333.06,4605.94
13/11/2020,BP,SAVE THE CHANGE,0.03,,3272.88
12/11/2020,DEB,AMZNMktplace,16.97,,3272.91
11/11/2020,FPI,ALHARBI M,,1000,3289.88
11/11/2020,BP,SAVE THE CHANGE,0.35,,2289.88
10/11/2020,DEB,LIDL GB NOTTINGHAM,33.65,,2290.23
10/11/2020,BP,SAVE THE CHANGE,0.87,,2323.88
09/11/2020,DEB,Amazon.co.uk*M73C5,3.64,,2324.75
09/11/2020,DEB,HOLLAND & BARRETT,5.49,,2328.39
09/11/2020,FPO,TRISTRAMS LETTINGS,825,,2333.88
09/11/2020,BP,SAVE THE CHANGE,1.96,,3158.88
09/11/2020,DEB,ORIENTAL MART HYDR,14.74,,3160.84
09/11/2020,DEB,LIDL GB NOTTINGHAM,11.07,,3175.58
09/11/2020,DEB,STARBUCKS,3.95,,3186.65
09/11/2020,DEB,POUNDSTRETCHER 63,2.28,,3190.6
09/11/2020,DEB,Trading212UK,1328,,3192.88
09/11/2020,DEB,Amazon.co.uk*M78CB,16,,4520.88
06/11/2020,DEB,Audible UK,18,,4536.88
06/11/2020,DEB,AMAZON.CO.UK*M74IF,15,,4554.88
06/11/2020,FPI,IISL CLIENT GBP SE,,1328,4569.88
06/11/2020,BP,SAVE THE CHANGE,0.5,,3241.88
05/11/2020,DEB,CO-OP GROUP 010661,9.5,,3242.38
05/11/2020,BP,SAVE THE CHANGE,0.46,,3251.88
04/11/2020,FPO,ALICJA ALEXANDER,25,,3252.34
04/11/2020,DEB,AMZNMktplace,19.54,,3277.34
04/11/2020,DEB,Trading212UK,1,,3296.88
04/11/2020,BP,SAVE THE CHANGE,0.82,,3297.88
03/11/2020,DEP,CLUB LLOYDS WAIVED,,3,3298.7
03/11/2020,FPO,TAMBA TAM,10,,3295.7
03/11/2020,PAY,CLUB LLOYDS FEE,3,,3305.7
03/11/2020,DEB,LIDL GB NOTTINGHAM,14.18,,3308.7
03/11/2020,SO,TRISTRAMS LETTINGS,825,,3322.88
03/11/2020,BP,SAVE THE CHANGE,0.58,,4147.88
02/11/2020,,INTEREST (GROSS),,1.71,4148.46
02/11/2020,DEB,CO-OP GROUP 010661,4.92,,4146.75
02/11/2020,DEB,PP*DOUGHNOTTS,5.5,,4151.67
02/11/2020,DD,NOTTM CITY COUNC,119,,4157.17
02/11/2020,DD,SEVERN TRENT WATER,25.7,,4276.17
02/11/2020,SO,ESAVINGS ACCOUNT,300,,4301.87
02/11/2020,BP,SAVE THE CHANGE,0.29,,4601.87
02/11/2020,DEB,ORIENTAL MART HYDR,14.72,,4602.16
02/11/2020,DEB,T K MAXX,8.99,,4616.88
02/11/2020,DEB,CO-OP GROUP 010661,4,,4625.87
30/10/2020,DEB,Trading212UK,1100,,4629.87
30/10/2020,DEB,DANCE IN TIME BOUT,5,,5729.87
30/10/2020,BP,SAVE THE CHANGE,1.36,,5734.87
29/10/2020,DEB,Trading212UK,1756,,5736.23
29/10/2020,DEB,LIDL GB NOTTINGHAM,17.14,,7492.23
29/10/2020,DEB,IZ *Secret Burger,8.5,,7509.37
29/10/2020,FPO,LAURA FOGLIATA,7,,7517.87
29/10/2020,DD,THE RENEWABLE ENER,100.65,,7524.87
29/10/2020,BP,SAVE THE CHANGE,0.9,,7625.52
29/10/2020,BGC,UNIV OF NOTTINGHAM,,3664.85,7626.42
28/10/2020,DEB,AMZNMktplace,15.1,,3961.57
28/10/2020,FPI,IISL CLIENT GBP SE,,1756,3976.67
27/10/2020,DD,TALKTALK LIMITED,19.95,,2220.67
27/10/2020,BP,SAVE THE CHANGE,0.45,,2240.62
26/10/2020,DEB,STARBUCKS,3.55,,2241.07
26/10/2020,BP,SAVE THE CHANGE,2.15,,2244.62
26/10/2020,DEB,ORIENTAL MART HYDR,13.28,,2246.77
26/10/2020,DEB,PP*DOUGHNOTTS,5.5,,2260.05
26/10/2020,DEB,Audible UK,7.99,,2265.55
26/10/2020,DEB,JUBILEE SHOP,5.08,,2273.54
23/10/2020,DEB,Trading212UK,1326,,2278.62
23/10/2020,DEB,Amazon.co.uk*XB9UV,15,,3604.62
23/10/2020,BP,SAVE THE CHANGE,0.14,,3619.62
22/10/2020,DEB,LIDL GB NOTTINGHAM,12.86,,3619.76
22/10/2020,FPO,LAURA FOGLIATA,7,,3632.62
22/10/2020,FPO,ALICJA ALEXANDER,25,,3639.62
22/10/2020,FPI,IISL CLIENT GBP SE,,1326,3664.62
22/10/2020,BP,SAVE THE CHANGE,0.51,,2338.62
21/10/2020,DEB,Amazon.co.uk*840ZD,3.49,,2339.13
21/10/2020,BP,SAVE THE CHANGE,0.72,,2342.62
20/10/2020,DEB,CO-OP GROUP 010661,10.29,,2343.34
20/10/2020,DEB,AMZNMKTPLACE AMAZO,5.99,,2353.63
20/10/2020,BP,SAVE THE CHANGE,0.53,,2359.62
19/10/2020,DEB,T K MAXX,11.97,,2360.15
19/10/2020,DEB,PP*DOUGHNOTTS,6.5,,2372.12
19/10/2020,BP,SAVE THE CHANGE,2.89,,2378.62
19/10/2020,DEB,Amazon.co.uk*EZ8KJ,16,,2381.51
19/10/2020,DEB,SOLO GRANO,13.31,,2397.51
19/10/2020,DEB,ORIENTAL MART HYDR,10.38,,2410.82
19/10/2020,DEB,JUBILEE SHOP,5.08,,2421.2
19/10/2020,DEB,STARBUCKS,3.35,,2426.28
16/10/2020,DEB,Trading212UK,926,,2429.63
16/10/2020,DEB,Trading212UK,75,,3355.63
16/10/2020,DEB,AMZNMktplace,33.99,,3430.63
16/10/2020,DD,O2,17.18,,3464.62
16/10/2020,BP,SAVE THE CHANGE,1.7,,3481.8
15/10/2020,FPO,LAURA FOGLIATA,3,,3483.5
15/10/2020,FPO,LAURA FOGLIATA,7,,3486.5
15/10/2020,DEB,LIDL GB NOTTINGHAM,21.11,,3493.5
15/10/2020,DEB,JUBILEE SHOP,6.19,,3514.61
15/10/2020,FPI,IISL CLIENT GBP SE,,926,3520.8
15/10/2020,BP,SAVE THE CHANGE,0.01,,2594.8
14/10/2020,DEB,AMZNMktplace,3.99,,2594.81
14/10/2020,BP,SAVE THE CHANGE,0.01,,2598.8
13/10/2020,FPO,TAMBA TAM,20,,2598.81
13/10/2020,DEB,AMZNMktplace,79.99,,2618.81
13/10/2020,BP,SAVE THE CHANGE,1.8,,2698.8
12/10/2020,DEB,PP*DOUGHNOTTS,4.5,,2700.6
12/10/2020,DEB,CAFFE NERO NOTTING,3.3,,2705.1
12/10/2020,DEB,WILKO RETAIL LIMIT,2.4,,2708.4
12/10/2020,BP,SAVE THE CHANGE,0.96,,2710.8
12/10/2020,DEB,ORIENTAL MART HYDR,16.7,,2711.76
12/10/2020,DEB,STARBUCKS,3.35,,2728.46
12/10/2020,DEB,AMZNMKTPLACE AMAZO,11.99,,2731.81
09/10/2020,BP,SAVE THE CHANGE,0.32,,2743.8
08/10/2020,FPO,ALICJA ALEXANDER,25,,2744.12
08/10/2020,FPO,LAURA FOGLIATA,7,,2769.12
08/10/2020,DEB,LIDL GB NOTTINGHAM,17.68,,2776.12
07/10/2020,DEB,Trading212UK,866,,2793.8
06/10/2020,FPO,TAMBA TAM,10,,3659.8
06/10/2020,TFR,R LAWRENCE,200,,3669.8
06/10/2020,FPI,IISL CLIENT GBP SE,,866,3869.8
06/10/2020,BP,SAVE THE CHANGE,0.3,,3003.8
05/10/2020,DEB,AMZNMktplace,7.99,,3004.1
05/10/2020,DEB,CO-OP GROUP 010661,4.71,,3012.09
05/10/2020,SO,TRISTRAMS LETTINGS,825,,3016.8
05/10/2020,BP,SAVE THE CHANGE,1.09,,3841.8
05/10/2020,DEB,MOGAL EXPRESS,11.77,,3842.89
05/10/2020,DEB,ORIENTAL MART HYDR,7.96,,3854.66
05/10/2020,DEB,ONEBELOW,3,,3862.62
05/10/2020,CPT,LNK 49-51 CLUMBER,40,,3865.62
02/10/2020,DEP,CLUB LLOYDS WAIVED,,3,3905.62
02/10/2020,PAY,CLUB LLOYDS FEE,3,,3902.62
02/10/2020,DEB,AMZNMktplace,46.18,,3905.62
02/10/2020,BP,SAVE THE CHANGE,0.23,,3951.8
01/10/2020,,INTEREST (GROSS),,2.39,3952.03
01/10/2020,FPO,LAURA FOGLIATA,7,,3949.64
01/10/2020,DEB,LIDL GB NOTTINGHAM,26.77,,3956.64
01/10/2020,DD,NOTTM CITY COUNC,119,,3983.41
01/10/2020,DD,SEVERN TRENT WATER,25.7,,4102.41
01/10/2020,SO,ESAVINGS ACCOUNT,300,,4128.11
01/10/2020,BP,SAVE THE CHANGE,0.2,,4428.11
30/09/2020,DEB,Trading212UK,1000,,4428.31
30/09/2020,DEB,AMZNMktplace,2.8,,5428.31
30/09/2020,DD,TALKTALK LIMITED,19.95,,5431.11
30/09/2020,BP,SAVE THE CHANGE,0.32,,5451.06
29/09/2020,DEB,AMAZON.CO.UK*JX79R,5.68,,5451.38
29/09/2020,FPO,TAMBA TAM,10,,5457.06
29/09/2020,DD,THE RENEWABLE ENER,74.3,,5467.06
29/09/2020,BP,SAVE THE CHANGE,1.53,,5541.36
29/09/2020,BGC,UNIV OF NOTTINGHAM,,3665.25,5542.89
28/09/2020,DEB,GHOUSIA FOODS,13.28,,1877.64
28/09/2020,DEB,CO-OP GROUP 010661,5.19,,1890.92
28/09/2020,BP,SAVE THE CHANGE,0.21,,1896.11
28/09/2020,DEB,Amazon.co.uk*KS7R7,6,,1896.32
28/09/2020,DEB,THE ORGAN GRINDER,1.8,,1902.32
25/09/2020,DEB,AMZNMktplace,14.99,,1904.12
25/09/2020,DEB,CO-OP GROUP 010661,7,,1919.11
25/09/2020,DEB,NBX*AT1.SPACE,175,,1926.11
25/09/2020,BP,SAVE THE CHANGE,0.86,,2101.11
24/09/2020,FPO,LAURA FOGLIATA,7,,2101.97
24/09/2020,DEB,LIDL GB NOTTINGHAM,12.15,,2108.97
24/09/2020,DEB,Audible UK,7.99,,2121.12
24/09/2020,FPO,ALICJA ALEXANDER,25,,2129.11
22/09/2020,FPO,TAMBA TAM,10,,2154.11
22/09/2020,FPO,EDWARD HANDS & LEW,350,,2164.11
22/09/2020,BP,SAVE THE CHANGE,0.02,,2514.11
21/09/2020,TFR,R LAWRENCE,300,,2514.13
21/09/2020,DEB,AMAZON.CO.UK*MY0NW,12.99,,2814.13
21/09/2020,DEB,AMZNMKTPLACE AMAZO,10.99,,2827.12
21/09/2020,FPI,ROTHERAS /CLI,,350,2838.11
21/09/2020,BP,SAVE THE CHANGE,1.39,,2488.11
21/09/2020,DEB,ORIENTAL MART HYDR,19.41,,2489.5
21/09/2020,DEB,HOLLAND & BARRETT,10.98,,2508.91
21/09/2020,DEB,GHOUSIA FOODS,17.98,,2519.89
21/09/2020,DEB,LIDL GB NOTTINGHAM,17.24,,2537.87
17/09/2020,DEB,Trading212UK,420,,2555.11
17/09/2020,BP,SAVE THE CHANGE,0.26,,2975.11
16/09/2020,DEB,Trading212UK,391,,2975.37
16/09/2020,DEB,AMZNMktplace,11.99,,3366.37
16/09/2020,DEB,CO-OP GROUP 010661,9.75,,3378.36
16/09/2020,DD,O2,16.63,,3388.11
15/09/2020,FPO,TAMBA TAM,10,,3404.74
15/09/2020,FPI,IISL CLIENT GBP SE,,391,3414.74
14/09/2020,FPO,LAURA FOGLIATA,7,,3023.74
14/09/2020,BP,SAVE THE CHANGE,1.88,,3030.74
14/09/2020,DEB,HOLLAND & BARRETT,4.99,,3032.62
14/09/2020,DEB,ORIENTAL MART HYDR,2.5,,3037.61
14/09/2020,DEB,AMZNMKTPLACE AMAZO,33.24,,3040.11
14/09/2020,DEB,LIDL GB NOTTINGHAM,9.39,,3073.35
11/09/2020,FPO,ALICJA ALEXANDER,25,,3082.74
09/09/2020,BP,SAVE THE CHANGE,0.16,,3107.74
08/09/2020,FPO,TAMBA TAM,10,,3107.9
08/09/2020,DEB,LIDL GB NOTTINGHAM,15.87,,3117.9
08/09/2020,DEB,T K MAXX,9.97,,3133.77
08/09/2020,BP,SAVE THE CHANGE,0.65,,3143.74
07/09/2020,DEB,AMZNMktplace,34.9,,3144.39
07/09/2020,DEB,ORIENTAL MART HYDR,14.46,,3179.29
07/09/2020,DEB,HOLLAND & BARRETT,4.99,,3193.75
07/09/2020,BP,SAVE THE CHANGE,0.86,,3198.74
07/09/2020,DEB,AMAZON.CO.UK*921DE,16.15,,3199.6
07/09/2020,DEB,AMZNMktplace,10.99,,3215.75
04/09/2020,BP,SAVE THE CHANGE,0.86,,3226.74
03/09/2020,DEB,LIDL GB NOTTINGHAM,16.14,,3227.6
03/09/2020,DEB,AMZNMktplace,,5.11,3243.74
03/09/2020,SO,TRISTRAMS LETTINGS,825,,3238.63
03/09/2020,BP,SAVE THE CHANGE,1.6,,4063.63
02/09/2020,DEP,CLUB LLOYDS WAIVED,,3,4065.23
02/09/2020,PAY,CLUB LLOYDS FEE,3,,4062.23
02/09/2020,DEB,AMZNMktplace,31.29,,4065.23
02/09/2020,DEB,AMZNMktplace,5.11,,4096.52
02/09/2020,BP,SAVE THE CHANGE,0.02,,4101.63
01/09/2020,,INTEREST (GROSS),,2.42,4101.65
01/09/2020,DEB,AMZNMktplace,43.99,,4099.23
01/09/2020,DEB,AMZNMKTPLACE AMAZO,10.99,,4143.22
01/09/2020,DD,NOTTM CITY COUNC,119,,4154.21
01/09/2020,DD,THE RENEWABLE ENER,68.52,,4273.21
01/09/2020,DD,SEVERN TRENT WATER,25.7,,4341.73
01/09/2020,SO,ESAVINGS ACCOUNT,300,,4367.43
01/09/2020,DEB,Trading212UK,1000,,4667.43
28/08/2020,FPO,TAMBA TAM,10,,5667.43
28/08/2020,DD,UCU B ACCOUNT,24.76,,5677.43
28/08/2020,DD,TALKTALK LIMITED,19.95,,5702.19
28/08/2020,DD,UCU B ACCOUNT,10,,5722.14
28/08/2020,BP,SAVE THE CHANGE,0.01,,5732.14
27/08/2020,DEB,AMZNMktplace,25.99,,5732.15
27/08/2020,BGC,UNIV OF NOTTINGHAM,,3665.25,5758.14
26/08/2020,FPO,ALICJA ALEXANDER,25,,2092.89
25/08/2020,DEB,LIDL GB NOTTINGHAM,9,,2117.89
25/08/2020,BP,SAVE THE CHANGE,0.05,,2126.89
24/08/2020,DEB,AMZNMktplace,31.96,,2126.94
24/08/2020,DEB,Audible UK,7.99,,2158.9
24/08/2020,BP,SAVE THE CHANGE,2.81,,2166.89
24/08/2020,DEB,ONEBELOW,11.16,,2169.7
24/08/2020,DEB,ORIENTAL MART HYDR,10.18,,2180.86
24/08/2020,DEB,GREGGS PLC,1,,2191.04
21/08/2020,DEB,LIDL GB NOTTINGHAM,29.59,,2192.04
21/08/2020,DEB,AMZNMktplace,23.99,,2221.63
21/08/2020,DEB,AMAZON.CO.UK*8L7P1,10.27,,2245.62
21/08/2020,BP,SAVE THE CHANGE,0.26,,2255.89
20/08/2020,DEB,AMZNMktplace,12.74,,2256.15
20/08/2020,DEB,NBX*AT1.SPACE,30,,2268.89
20/08/2020,BP,SAVE THE CHANGE,0.5,,2298.89
19/08/2020,DEB,SUMUP  *THE PLANT,6.5,,2299.39
19/08/2020,BP,SAVE THE CHANGE,0.05,,2305.89
18/08/2020,DEB,AMZNMktplace,7.95,,2305.94
18/08/2020,BP,SAVE THE CHANGE,0.32,,2313.89
17/08/2020,DEB,CAFFE NERO NOTTING,3.7,,2314.21
17/08/2020,DEB,WHEELHOUSE,13.98,,2317.91
17/08/2020,DD,O2,19.44,,2331.89
17/08/2020,BP,SAVE THE CHANGE,1.52,,2351.33
17/08/2020,DEB,ORIENTAL MART HYDR,5,,2352.85
17/08/2020,DEB,HOLLAND & BARRETT,4,,2357.85
17/08/2020,DEB,GREGGS PLC,2,,2361.85
17/08/2020,DEB,AMZNMktplace,8.28,,2363.85
17/08/2020,DEB,AMAZON.CO.UK*TU7DO,3.47,,2372.13
14/08/2020,DEB,DANCE IN TIME BOUT,5,,2375.6
14/08/2020,DEB,AMZNMKTPLACE AMAZO,74.73,,2380.6
14/08/2020,FPO,ALICJA ALEXANDER,25,,2455.33
14/08/2020,BP,SAVE THE CHANGE,1.04,,2480.33
13/08/2020,DEB,Trading212UK,250,,2481.37
13/08/2020,DEB,LIDL GB NOTTINGHAM,30.35,,2731.37
13/08/2020,DEB,AMAZON.CO.UK*9S008,6.61,,2761.72
11/08/2020,BP,SAVE THE CHANGE,0.95,,2768.33
10/08/2020,DEB,AMZNMktplace,9.05,,2769.28
10/08/2020,BP,SAVE THE CHANGE,1.44,,2778.33
10/08/2020,DEB,ORIENTAL MART HYDR,11.49,,2779.77
10/08/2020,DEB,HOLLAND & BARRETT,4.99,,2791.26
10/08/2020,DEB,STARBUCKS,3.5,,2796.25
10/08/2020,DEB,AMZNMKTPLACE AMAZO,49.96,,2799.75
10/08/2020,DEB,GHOUSIA FOODS,14.62,,2849.71
07/08/2020,CPT,LNK PO MIDDLETONBO,40,,2864.33
07/08/2020,DEB,DANCE IN TIME BOUT,5,,2904.33
05/08/2020,DEB,AMZ*momox co uk,,14.63,2909.33
04/08/2020,DEP,CLUB LLOYDS WAIVED,,3,2894.7
04/08/2020,PAY,CLUB LLOYDS FEE,3,,2891.7
04/08/2020,BP,SAVE THE CHANGE,0.15,,2894.7
03/08/2020,,INTEREST (GROSS),,2.25,2894.85
03/08/2020,DEB,COSTA COFFEE 43038,2.85,,2892.6
03/08/2020,FPO,TAMBA TAM,10,,2895.45
03/08/2020,DD,NOTTM CITY COUNC,119,,2905.45
03/08/2020,DD,SEVERN TRENT WATER,25.7,,3024.45
03/08/2020,SO,TRISTRAMS LETTINGS,825,,3050.15
03/08/2020,SO,ESAVINGS ACCOUNT,300,,3875.15
03/08/2020,BP,SAVE THE CHANGE,1.16,,4175.15
03/08/2020,DEB,GHOUSIA FOODS,8.53,,4176.31
03/08/2020,DEB,ORIENTAL MART HYDR,5.94,,4184.84
03/08/2020,DEB,HOLLAND & BARRETT,4.99,,4190.78
03/08/2020,DEB,Trading212UK,1000,,4195.77
03/08/2020,DEB,AMZNMktplace,19.99,,5195.77
03/08/2020,DEB,AMAZON.CO.UK AMAZO,,3.47,5215.76
31/07/2020,DEB,LIDL GB NOTTINGHAM,21.39,,5212.29
31/07/2020,DD,UCU B ACCOUNT,24.76,,5233.68
31/07/2020,BP,SAVE THE CHANGE,0.5,,5258.44
30/07/2020,DEB,Amazon.co.uk*7C4AV,4.5,,5258.94
30/07/2020,DD,THE RENEWABLE ENER,23.25,,5263.44
30/07/2020,BGC,UNIV OF NOTTINGHAM,,3924.85,5286.69
29/07/2020,FPO,ALICJA ALEXANDER,25,,1361.84
29/07/2020,BP,SAVE THE CHANGE,0.18,,1386.84
28/07/2020,DEB,AMZNMktplace,10.82,,1387.02
28/07/2020,BP,SAVE THE CHANGE,0.21,,1397.84
27/07/2020,DEB,AMZNMktplace,12.79,,1398.05
27/07/2020,FPO,ROTHERAS SOLICITOR,350,,1410.84
27/07/2020,DD,TALKTALK LIMITED,19.95,,1760.84
27/07/2020,BP,SAVE THE CHANGE,1.11,,1780.79
27/07/2020,DEB,ORIENTAL MART HYDR,6.85,,1781.9
27/07/2020,DEB,CAFFE NERO 650 NOT,3.05,,1788.75
24/07/2020,DEB,Audible UK,7.99,,1791.8
24/07/2020,BP,SAVE THE CHANGE,0.04,,1799.79
23/07/2020,DEB,AMZNMktplace,44.98,,1799.83
23/07/2020,DEB,AMZNMktplace,23.98,,1844.81
22/07/2020,BP,SAVE THE CHANGE,0.62,,1868.79
21/07/2020,DEB,CO-OP GROUP 010661,22.38,,1869.41
21/07/2020,BP,SAVE THE CHANGE,0.97,,1891.79
20/07/2020,DEB,AMZNMKTPLACE AMAZO,18.99,,1892.76
20/07/2020,DEB,AMZNMktplace,13.99,,1911.75
20/07/2020,DEB,CAFFE NERO 650 NOT,3.05,,1925.74
20/07/2020,BP,SAVE THE CHANGE,1.49,,1928.79
20/07/2020,DEB,ORIENTAL MART HYDR,8.9,,1930.28
20/07/2020,DEB,HOLLAND & BARRETT,6.49,,1939.18
20/07/2020,DEB,AMZNMktplace,45.49,,1945.67
17/07/2020,DEB,AMZNMktplace,25.93,,1991.16
17/07/2020,DEB,GHOUSIA FOODS,18.7,,2017.09
17/07/2020,BP,SAVE THE CHANGE,1.11,,2035.79
16/07/2020,DEB,AMZNMktplace,22.62,,2036.9
16/07/2020,DEB,GHOUSIA FOODS,21.27,,2059.52
16/07/2020,DD,O2,16.44,,2080.79
15/07/2020,FPO,ALICJA ALEXANDER,25,,2097.23
15/07/2020,BP,SAVE THE CHANGE,1.2,,2122.23
14/07/2020,DEB,Amazon.co.uk*K27LK,32.15,,2123.43
14/07/2020,DEB,LIDL GB NOTTINGHAM,7.65,,2155.58
14/07/2020,BP,SAVE THE CHANGE,0.01,,2163.23
13/07/2020,DEB,AMZNMKTPLACE AMAZO,17.99,,2163.24
13/07/2020,BP,SAVE THE CHANGE,0.92,,2181.23
13/07/2020,DEB,Audible UK,18,,2182.15
13/07/2020,DEB,ORIENTAL MART HYDR,10.95,,2200.15
13/07/2020,DEB,GREGGS PLC,2,,2211.1
13/07/2020,DEB,LIDL GB NOTTINGHAM,15.14,,2213.1
13/07/2020,DEB,AMAZON.CO.UK*HR2BI,12.99,,2228.24
09/07/2020,FPO,SALLY GOLDSTONE,321,,2241.23
09/07/2020,BP,SAVE THE CHANGE,0.07,,2562.23
08/07/2020,DEB,LIDL GB NOTTINGHAM,14.93,,2562.3
07/07/2020,BP,SAVE THE CHANGE,0.47,,2577.23
06/07/2020,DEB,DISNEY STORE NOTTI,13,,2577.7
06/07/2020,DEB,ONEBELOW,7.53,,2590.7
06/07/2020,DEB,GREGGS PLC,2,,2598.23
06/07/2020,BP,SAVE THE CHANGE,1.07,,2600.23
06/07/2020,DEB,STARBUCKS,3.55,,2601.3
03/07/2020,DEB,AMZNMktplace,31.97,,2604.85
03/07/2020,DEB,LIDL GB NOTTINGHAM,20.62,,2636.82
03/07/2020,DEB,AMZNMktplace,16.79,,2657.44
03/07/2020,SO,TRISTRAMS LETTINGS,825,,2674.23
02/07/2020,DEP,CLUB LLOYDS WAIVED,,3,3499.23
02/07/2020,PAY,CLUB LLOYDS FEE,3,,3496.23
02/07/2020,DEB,Trading212UK,1000,,3499.23
02/07/2020,BP,SAVE THE CHANGE,0.01,,4499.23
01/07/2020,,INTEREST (GROSS),,1.58,4499.24
01/07/2020,DEB,Trading212UK,6000,,4497.66
01/07/2020,DEB,AMZNMKTPLACE AMAZO,17.99,,10497.66
01/07/2020,FPO,ALICJA ALEXANDER,25,,10515.65
01/07/2020,DD,NOTTM CITY COUNC,119,,10540.65
01/07/2020,DD,SEVERN TRENT WATER,25.7,,10659.65
01/07/2020,SO,ESAVINGS ACCOUNT,300,,10685.35
01/07/2020,BP,SAVE THE CHANGE,0.68,,10985.35
30/06/2020,DEB,Amazon.co.uk*7R62C,5.32,,10986.03
30/06/2020,DD,UCU B ACCOUNT,24.76,,10991.35
29/06/2020,DD,THE RENEWABLE ENER,88.54,,11016.11
29/06/2020,BP,SAVE THE CHANGE,1.52,,11104.65
29/06/2020,BGC,UNIV OF NOTTINGHAM,,9996.45,11106.17
29/06/2020,DEB,ONEBELOW,13.27,,1109.72
29/06/2020,DEB,HOLLAND & BARRETT,9.67,,1122.99
29/06/2020,DEB,ORIENTAL MART HYDR,2.6,,1132.66
29/06/2020,DEB,GREGGS PLC,2,,1135.26
26/06/2020,DEB,LIDL GB NOTTINGHAM,19.94,,1137.26
26/06/2020,DD,TALKTALK LIMITED,11.85,,1157.2
26/06/2020,BP,SAVE THE CHANGE,0.91,,1169.05
25/06/2020,DEB,GHOUSIA FOODS,22.09,,1169.96
25/06/2020,BP,SAVE THE CHANGE,0.01,,1192.05
24/06/2020,DEB,Audible UK,7.99,,1192.06
24/06/2020,BP,SAVE THE CHANGE,0.05,,1200.05
24/06/2020,BGC,GOOGLE IRELAND,,65.41,1200.1
23/06/2020,DEB,Amazon.co.uk*UK1KA,9.95,,1134.69
23/06/2020,BP,SAVE THE CHANGE,0.61,,1144.64
22/06/2020,DEB,LIDL GB NOTTINGHAM,12.39,,1145.25
22/06/2020,DEB,GREGGS PLC,3,,1157.64
22/06/2020,BP,SAVE THE CHANGE,0.54,,1160.64
22/06/2020,DEB,T K MAXX,18.97,,1161.18
22/06/2020,CPT,LNK INTU VICTORIA,40,,1180.15
19/06/2020,FPO,ALICJA ALEXANDER,25,,1220.15
19/06/2020,DEB,AMZNMktplace,9.49,,1245.15
19/06/2020,BP,SAVE THE CHANGE,0.49,,1254.64
18/06/2020,DEB,LIDL GB NOTTINGHAM,10.51,,1255.13
18/06/2020,BP,SAVE THE CHANGE,1.22,,1265.64
17/06/2020,DEB,GHOUSIA FOODS,18.68,,1266.86
17/06/2020,DEB,CO-OP GROUP 010661,11.1,,1285.54
16/06/2020,DD,O2,16.44,,1296.64
16/06/2020,BP,SAVE THE CHANGE,0.15,,1313.08
15/06/2020,FPO,SALLY GOLDSTONE,155,,1313.23
15/06/2020,DEB,AMZNMktplace,64.85,,1468.23
15/06/2020,BP,SAVE THE CHANGE,1.47,,1533.08
15/06/2020,DEB,LIDL GB NOTTINGHAM,26.18,,1534.55
12/06/2020,DEB,Amazon.co.uk*OS1EB,10.99,,1560.73
12/06/2020,DEB,AMAZON.CO.UK*Z401P,14.36,,1571.72
11/06/2020,BP,SAVE THE CHANGE,0.36,,1586.08
10/06/2020,DEB,GHOUSIA FOODS,13.64,,1586.44
10/06/2020,BP,SAVE THE CHANGE,1.11,,1600.08
09/06/2020,,INTEREST (GROSS),,3.17,1601.19
09/06/2020,DEB,AMZNMktplace,177.87,,1598.02
09/06/2020,DEB,AMZNMKTPLACE AMAZO,3.02,,1775.89
08/06/2020,BP,SAVE THE CHANGE,1.14,,1778.91
08/06/2020,DEB,ORIENTAL MART HYDR,26.23,,1780.05
08/06/2020,DEB,LIDL GB NOTTINGHAM,24.63,,1806.28
05/06/2020,DEB,Trading212UK,520,,1830.91
05/06/2020,BGC,INFORMA UK LTD,,75,2350.91
04/06/2020,DEB,FARM FRESH NOTTING,18,,2275.91
04/06/2020,BP,SAVE THE CHANGE,0.64,,2293.91
03/06/2020,DEB,Trading212UK,320,,2294.55
03/06/2020,DEB,GHOUSIA FOODS,29.36,,2614.55
03/06/2020,SO,TRISTRAMS LETTINGS,825,,2643.91
03/06/2020,BP,SAVE THE CHANGE,0.01,,3468.91
02/06/2020,DEP,CLUB LLOYDS WAIVED,,3,3468.92
02/06/2020,PAY,CLUB LLOYDS FEE,3,,3465.92
02/06/2020,DEB,Trading212UK,1000,,3468.92
02/06/2020,DEB,AMZNMktplace,15.99,,4468.92
02/06/2020,FPO,ALICJA ALEXANDER,25,,4484.91
01/06/2020,DD,NOTTM CITY COUNC,119,,4509.91
01/06/2020,DD,THE RENEWABLE ENER,29.55,,4628.91
01/06/2020,DD,SEVERN TRENT WATER,25.77,,4658.46
01/06/2020,SO,ESAVINGS ACCOUNT,300,,4684.23
01/06/2020,BP,SAVE THE CHANGE,2.41,,4984.23
29/05/2020,DEB,Trading212UK,1000,,4986.64
29/05/2020,DEB,LIDL GB NOTTINGHAM,23.31,,5986.64
29/05/2020,DEB,AMZNMKTPLACE AMAZO,20.08,,6009.95
29/05/2020,DEB,AMAZON.CO.UK*BZ9XP,9.2,,6030.03
29/05/2020,DD,UCU B ACCOUNT,24.76,,6039.23
28/05/2020,BP,SAVE THE CHANGE,1.29,,6063.99
28/05/2020,BGC,UNIV OF NOTTINGHAM,,3578.45,6065.28
27/05/2020,DEB,AMZN Mktp US*M74TR,10.56,,2486.83
27/05/2020,DEB,CO-OP GROUP 010661,7.65,,2497.39
27/05/2020,DEB,Amazon.co.uk*EE5SK,2.5,,2505.04
26/05/2020,BP,SAVE THE CHANGE,1.23,,2507.54
26/05/2020,DEB,CO-OP GROUP 010661,14.25,,2508.77
26/05/2020,DEB,Audible UK,7.99,,2523.02
26/05/2020,DEB,GHOUSIA FOODS,13.53,,2531.01
22/05/2020,FPO,SALLY GOLDSTONE,45,,2544.54
22/05/2020,BP,SAVE THE CHANGE,0.1,,2589.54
21/05/2020,DEB,AMZNMKTPLACE AMAZO,14.9,,2589.64
21/05/2020,FPO,ALICJA ALEXANDER,25,,2604.54
19/05/2020,DEB,Trading212UK,500,,2629.54
19/05/2020,BP,SAVE THE CHANGE,0.34,,3129.54
18/05/2020,DEB,HOLLAND & BARRETT,21.66,,3129.88
18/05/2020,DD,O2,16.44,,3151.54
18/05/2020,BP,SAVE THE CHANGE,0.41,,3167.98
18/05/2020,DEB,ORIENTAL MART HYDR,19.84,,3168.39
18/05/2020,DEB,Amazon.co.uk*W52CT,10.75,,3188.23
18/05/2020,CPT,LOYD LOYD LOWER PA,40,,3198.98
15/05/2020,DEB,AMZNMKTPLACE AMAZO,,12.14,3238.98
15/05/2020,BP,SAVE THE CHANGE,1.51,,3226.84
14/05/2020,DEB,AMZN Mktp US*MC8CK,25.35,,3228.35
14/05/2020,DEB,AMZNMKTPLACE AMAZO,12.14,,3253.7
14/05/2020,BP,SAVE THE CHANGE,0.42,,3265.84
13/05/2020,DEB,CO-OP GROUP 010661,12.58,,3266.26
13/05/2020,DEB,Trading212UK,500,,3278.84
11/05/2020,BP,SAVE THE CHANGE,1.56,,3778.84
11/05/2020,DEB,AMAZON.CO.UK AMAZO,,23.96,3780.4
11/05/2020,DEB,AMZ*Amazon.co.uk,,23.96,3756.44
11/05/2020,DEB,AMZNMktplace,68.46,,3732.48
11/05/2020,DEB,GHOUSIA FOODS,39.03,,3800.94
11/05/2020,DEB,AMZNMktplace,7.95,,3839.97
07/05/2020,BP,SAVE THE CHANGE,0.67,,3847.92
06/05/2020,DEB,AMZNMKTPLACE AMAZO,23.71,,3848.59
06/05/2020,DEB,LIDL GB NOTTINGHAM,22.62,,3872.3
06/05/2020,DEB,AMAZON.CO.UK*WS0FS,15,,3894.92
05/05/2020,FPO,ALICJA ALEXANDER,25,,3909.92
05/05/2020,BP,SAVE THE CHANGE,0.06,,3934.92
04/05/2020,DEP,CLUB LLOYDS WAIVED,,3,3934.98
04/05/2020,PAY,CLUB LLOYDS FEE,3,,3931.98
04/05/2020,DEB,AMZNMKTPLACE AMAZO,23.94,,3934.98
04/05/2020,SO,TRISTRAMS LETTINGS,825,,3958.92
04/05/2020,BP,SAVE THE CHANGE,2.07,,4783.92
04/05/2020,DEB,AMZNMktplace,7.57,,4785.99
04/05/2020,DEB,AMZNMKTPLACE AMAZO,14.45,,4793.56
04/05/2020,DEB,AMZNMKTPLACE AMAZO,2.82,,4808.01
04/05/2020,DEB,AMZNMKTPLACE AMAZO,14.1,,4810.83
04/05/2020,DEB,AMZNMKTPLACE AMAZO,12.99,,4824.93
01/05/2020,,INTEREST (GROSS),,3.36,4837.92
01/05/2020,DEB,Trading212UK,1000,,4834.56
01/05/2020,DD,NOTTM CITY COUNC,119,,5834.56
01/05/2020,DD,SEVERN TRENT WATER,15.37,,5953.56
01/05/2020,SO,ESAVINGS ACCOUNT,300,,5968.93
30/04/2020,DD,UCU B ACCOUNT,24.76,,6268.93
29/04/2020,BP,SAVE THE CHANGE,0.01,,6293.69
29/04/2020,BGC,UNIV OF NOTTINGHAM,,3578.85,6293.7
28/04/2020,DEB,AMZNMktplace,26.99,,2714.85
28/04/2020,BP,SAVE THE CHANGE,0.05,,2741.84
27/04/2020,DEB,LIDL GB NOTTINGHAM,18.95,,2741.89
27/04/2020,BP,SAVE THE CHANGE,0.01,,2760.84
27/04/2020,DEB,WWW.III.CO.UK DE,40,,2760.85
24/04/2020,DEB,AMAZON.CO.UK*PR1TB,79,,2800.85
24/04/2020,DEB,Audible UK,7.99,,2879.85
23/04/2020,FPO,ALICJA ALEXANDER,25,,2887.84
23/04/2020,BP,SAVE THE CHANGE,0.04,,2912.84
22/04/2020,DEB,Amazon.co.uk*SE9IM,23.96,,2912.88
22/04/2020,BP,SAVE THE CHANGE,0.7,,2936.84
21/04/2020,DEB,LIDL GB NOTTINGHAM,25.3,,2937.54
20/04/2020,BP,SAVE THE CHANGE,1.33,,2962.84
20/04/2020,DEB,GHOUSIA FOODS,22.69,,2964.17
20/04/2020,DEB,ECOTRICITY,126.81,,2986.86
20/04/2020,DEB,AMZNMKTPLACE AMAZO,3.58,,3113.67
17/04/2020,DEB,AMZNMKTPLACE AMAZO,2.59,,3117.25
17/04/2020,BP,SAVE THE CHANGE,0.75,,3119.84
16/04/2020,DEB,AMZNMKTPLACE AMAZO,61.25,,3120.59
16/04/2020,DD,O2,19.59,,3181.84
16/04/2020,BP,SAVE THE CHANGE,0.82,,3201.43
15/04/2020,DEB,WWW.SO.ENERGY,199.56,,3202.25
15/04/2020,DEB,AMZNMKTPLACE AMAZO,25,,3401.81
15/04/2020,DEB,LIDL GB NOTTINGHAM,18.62,,3426.81
14/04/2020,DD,VIRGIN MEDIA PYMTS,14.43,,3445.43
14/04/2020,BP,SAVE THE CHANGE,1.63,,3459.86
14/04/2020,DEB,AMAZON.CO.UK*7V4G4,38.32,,3461.49
14/04/2020,DEB,Audible UK,8.2,,3499.81
14/04/2020,DEB,WWW.III.CO.UK DE,1000,,3508.01
14/04/2020,DEB,WWW.III.CO.UK DE,500,,4508.01
09/04/2020,DEB,WWW.III.CO.UK DE,1000,,5008.01
09/04/2020,DEB,LIDL GB NOTTINGHAM,26.85,,6008.01
09/04/2020,BP,SAVE THE CHANGE,0.36,,6034.86
08/04/2020,DEB,WWW.III.CO.UK DE,2000,,6035.22
08/04/2020,DEB,AMZNMktplace,26.72,,8035.22
08/04/2020,DEB,AMZNMktplace,25.92,,8061.94
07/04/2020,FPO,ALICJA ALEXANDER,25,,8087.86
07/04/2020,BP,SAVE THE CHANGE,0.05,,8112.86
06/04/2020,DEB,GHOUSIA FOODS,30.95,,8112.91
06/04/2020,BP,SAVE THE CHANGE,2.4,,8143.86
06/04/2020,DEB,AMAZON.CO.UK*6Z8T6,25.76,,8146.26
06/04/2020,DEB,AMZNMKTPLACE AMAZO,11.15,,8172.02
06/04/2020,CPT,LNK UNIVERSITY PAR,40,,8183.17
06/04/2020,DEB,AMZNMKTPLACE AMAZO,30.25,,8223.17
06/04/2020,DEB,LIDL GB NOTTINGHAM,25.44,,8253.42
03/04/2020,SO,TRISTRAMS LETTINGS,825,,8278.86
02/04/2020,DEP,CLUB LLOYDS WAIVED,,3,9103.86
02/04/2020,PAY,CLUB LLOYDS FEE,3,,9100.86
02/04/2020,BP,SAVE THE CHANGE,0.01,,9103.86
01/04/2020,,INTEREST (GROSS),,4.71,9103.87
01/04/2020,DEB,AMZNMktplace,21.99,,9099.16
01/04/2020,DD,NOTTM CITY COUNC,115.47,,9121.15
01/04/2020,DD,SEVERN TRENT WATER,15.31,,9236.62
01/04/2020,SO,ESAVINGS ACCOUNT,300,,9251.93
31/03/2020,DD,UCU B ACCOUNT,24.76,,9551.93
31/03/2020,DD,TALKTALK LIMITED,19.95,,9576.69
30/03/2020,BP,SAVE THE CHANGE,0.15,,9596.64
30/03/2020,BGC,UNIV OF NOTTINGHAM,,4336.21,9596.79
30/03/2020,DEB,AMZNMktplace,21,,5260.58
30/03/2020,DEB,LIDL GB NOTTINGHAM,20.85,,5281.58
27/03/2020,BP,SAVE THE CHANGE,0.87,,5302.43
26/03/2020,DEB,LIDL GB NOTTINGHAM,8.24,,5303.3
26/03/2020,DEB,AMAZON.CO.UK*MC22D,7.89,,5311.54
25/03/2020,BP,SAVE THE CHANGE,1.24,,5319.43
24/03/2020,DEB,AMZNMktplace,33.98,,5320.67
24/03/2020,DEB,ORIENTAL MART,19.6,,5354.65
24/03/2020,DEB,LIDL GB NOTTINGHAM,14.19,,5374.25
24/03/2020,DEB,Audible UK,7.99,,5388.44
24/03/2020,FPO,ALICJA ALEXANDER,25,,5396.43
24/03/2020,BP,SAVE THE CHANGE,0.76,,5421.43
23/03/2020,DEB,YANKEE STORE,12.24,,5422.19
23/03/2020,DD,HARLANDS,25,,5434.43
23/03/2020,BP,SAVE THE CHANGE,1.38,,5459.43
23/03/2020,DEB,HOLLAND & BARRETT,24.68,,5460.81
23/03/2020,DEB,AMAZON.CO.UK*425LQ,7.75,,5485.49
20/03/2020,DEB,AMAZON.CO.UK*GF4UX,13.99,,5493.24
20/03/2020,DEB,TESCO STORES 6735,7.2,,5507.23
20/03/2020,CPT,LNK NOTTINGHAM UNI,40,,5514.43
20/03/2020,BP,SAVE THE CHANGE,0.5,,5554.43
19/03/2020,DEB,WWW.III.CO.UK DE,4000,,5554.93
19/03/2020,DEB,LIDL GB NOTTINGHAM,8.5,,9554.93
19/03/2020,BP,SAVE THE CHANGE,0.39,,9563.43
19/03/2020,BGC,DWR CYMRU WELSH WA,,180.29,9563.82
18/03/2020,DEB,GHOUSIA FOODS,28.61,,9383.53
18/03/2020,TFR,R LAWRENCE,,4350.57,9412.14
18/03/2020,BP,SAVE THE CHANGE,0.01,,5061.57
17/03/2020,DEB,AMZNMktplace,13.99,,5061.58
17/03/2020,DEB,AMZ*Amazon.co.uk,,5,5075.57
16/03/2020,FPI,ANMF CREDIT,,959.1,5070.57
16/03/2020,DD,O2,14.72,,4111.47
16/03/2020,BP,SAVE THE CHANGE,0.72,,4126.19
16/03/2020,DEB,IZ *BIRD & BLEND T,15,,4126.91
16/03/2020,DEB,LIDL GB NOTTINGHAM,10.29,,4141.91
16/03/2020,FPI,Q WANG   14MAR20,,300,4152.2
16/03/2020,CPT,LNK TESCO LONG ROW,40,,3852.2
13/03/2020,DEB,WWW.III.CO.UK DE,5000,,3892.2
13/03/2020,DEB,HARLANDS GROUP,110,,8892.2
13/03/2020,DEB,AMZNMktplace,31.99,,9002.2
12/03/2020,CPT,LNK NOTTINGHAM UNI,40,,9034.19
12/03/2020,FPO,ALICJA ALEXANDER,25,,9074.19
12/03/2020,BP,SAVE THE CHANGE,0.01,,9099.19
11/03/2020,DEB,AMZNMktplace,12.99,,9099.2
11/03/2020,BGC,GOOD ENERGY LTD,,290.18,9112.19
10/03/2020,FPO,TRISTRAMS LETTINGS,825,,8822.01
09/03/2020,DEB,Amazon Prime*2S40E,79,,9647.01
09/03/2020,CPT,LNK H&T NOTTINGHAM,50,,9726.01
06/03/2020,CPT,LNK NOTTINGHAM UNI,50,,9776.01
06/03/2020,FPO,SALLY GOLDSTONE,231,,9826.01
06/03/2020,TFR,R LAWRENCE,84000,,10057.01
06/03/2020,BP,SAVE THE CHANGE,0.17,,94057.01
05/03/2020,DEB,CO-OP GROUP 010661,8.83,,94057.18
03/03/2020,DEP,CLUB LLOYDS WAIVED,,3,94066.01
03/03/2020,PAY,CLUB LLOYDS FEE,3,,94063.01
03/03/2020,TFR,F/FLOW HOWELLS LEG,,83840.54,94066.01
03/03/2020,CPT,LNK NOTTINGHAM UNI,40,,10225.47
03/03/2020,BP,SAVE THE CHANGE,0.48,,10265.47
02/03/2020,,INTEREST (GROSS),,4.56,10265.95
02/03/2020,DEB,WWW.III.CO.UK DE,5000,,10261.39
02/03/2020,DEB,EB *REGGEATON WORK,13.52,,15261.39
02/03/2020,DD,SANTANDER MORTGAGE,959.1,,15274.91
02/03/2020,DD,DWR CYMRU W WATER,32.5,,16234.01
02/03/2020,SO,ESAVINGS ACCOUNT,300,,16266.51
02/03/2020,BP,SAVE THE CHANGE,0.37,,16566.51
02/03/2020,DEB,WWW.III.CO.UK DE,5000,,16566.88
02/03/2020,DEB,LIDL GB NOTTINGHAM,8.74,,21566.88
02/03/2020,TFR,R LAWRENCE  01MAR20,,5000,21575.62
02/03/2020,DEB,LIDL GB NOTTINGHAM,7.89,,16575.62
02/03/2020,CPT,LNK SAINSBURYS BAN,40,,16583.51
02/03/2020,TFR,R LAWRENCE  29FEB20,,5000,16623.51
28/02/2020,DD,UCU B ACCOUNT,24.76,,11623.51
28/02/2020,DD,TALKTALK LIMITED,19.3,,11648.27
28/02/2020,BP,SAVE THE CHANGE,0.52,,11667.57
27/02/2020,DEB,AMZNMktplace,18.99,,11668.09
27/02/2020,DEB,AMZNMKTPLACE AMAZO,6.49,,11687.08
27/02/2020,BGC,UNIV OF NOTTINGHAM,,3436.27,11693.57
26/02/2020,DEB,WWW.FATSOMA.COM,8,,8257.3
26/02/2020,CPT,LNK NOTTINGHAM UNI,40,,8265.3
26/02/2020,BP,SAVE THE CHANGE,0.36,,8305.3
25/02/2020,DEB,AMZNMktplace,26.64,,8305.66
25/02/2020,BP,SAVE THE CHANGE,0.01,,8332.3
24/02/2020,DEB,Audible UK,7.99,,8332.31
24/02/2020,BP,SAVE THE CHANGE,0.42,,8340.3
24/02/2020,DEB,TIMPSON LTD,20,,8340.72
24/02/2020,DEB,LIDL GB NOTTINGHAM,7.58,,8360.72
24/02/2020,DEB,WWW.SU.NOTTINGHAM.,44,,8368.3
21/02/2020,DEB,WWW.III.CO.UK DE,1100,,8412.3
21/02/2020,CPT,LNK UNIVERSITY PAR,40,,9512.3
21/02/2020,BP,SAVE THE CHANGE,0.69,,9552.3
20/02/2020,DEB,CO-OP GROUP 010661,13.31,,9552.99
20/02/2020,BP,SAVE THE CHANGE,0.04,,9566.3
19/02/2020,DEB,AMZNMktplace,43.96,,9566.34
19/02/2020,BP,SAVE THE CHANGE,0.12,,9610.3
18/02/2020,DEB,LIDL GB NOTTINGHAM,9.88,,9610.42
18/02/2020,FPO,TRISTRAMS,22.5,,9620.3
17/02/2020,CPT,LNK NOTTINGHAM UNI,40,,9642.8
17/02/2020,DD,O2,18.94,,9682.8
17/02/2020,BP,SAVE THE CHANGE,1.25,,9701.74
17/02/2020,BGC,C C SWANSEA,,224.71,9702.99
17/02/2020,DEB,ATRIUM JUBILEE 1,3.4,,9478.28
17/02/2020,DEB,Audible UK,18,,9481.68
17/02/2020,DEB,LIDL GB NOTTINGHAM,12.35,,9499.68
14/02/2020,CPT,LNK NOTTINGHAM UNI,40,,9512.03
14/02/2020,BP,SAVE THE CHANGE,0.83,,9552.03
13/02/2020,DEB,CO-OP GROUP 010661,11.17,,9552.86
11/02/2020,BP,SAVE THE CHANGE,0.45,,9564.03
10/02/2020,DEB,TIMPSON LTD,15,,9564.48
10/02/2020,DEB,GHOUSIA FOODS,36.55,,9579.48
10/02/2020,CPT,LNK NOTTINGHAM UNI,40,,9616.03
10/02/2020,BP,SAVE THE CHANGE,0.7,,9656.03
10/02/2020,DEB,CO-OP GROUP 010661,8.3,,9656.73
06/02/2020,BP,SAVE THE CHANGE,0.01,,9665.03
05/02/2020,DEB,POST OFFICE COUNTE,46.99,,9665.04
05/02/2020,FPO,BORIS REMOVALS,1100,,9712.03
05/02/2020,BP,SAVE THE CHANGE,0.6,,10812.03
04/02/2020,DEP,CLUB LLOYDS WAIVED,,3,10812.63
04/02/2020,PAY,CLUB LLOYDS FEE,3,,10809.63
04/02/2020,DEB,SAINSBURYS S/MKTS,30.4,,10812.63
04/02/2020,BP,SAVE THE CHANGE,0.75,,10843.03
03/02/2020,,INTEREST (GROSS),,5.21,10843.78
03/02/2020,DEB,ZINCO LOUNGE,16.25,,10838.57
03/02/2020,DEB,SQ *TIKI BAR,5,,10854.82
03/02/2020,CPT,LNK PO THE CITYOFS,50,,10859.82
03/02/2020,DD,SANTANDER MORTGAGE,959.09,,10909.82
03/02/2020,DD,GOOD ENERGY LTD,50,,11868.91
03/02/2020,DD,DWR CYMRU W WATER,32.5,,11918.91
03/02/2020,SO,ESAVINGS ACCOUNT,300,,11951.41
03/02/2020,BP,SAVE THE CHANGE,0.4,,12251.41
03/02/2020,DEB,WILKO RETAIL LIMIT,18,,12251.81
03/02/2020,DEB,Brontosaurus Vegan,16.62,,12269.81
03/02/2020,DEB,CORGI HOMEPLAN,24.98,,12286.43
31/01/2020,CPT,LNK M&S SWANSEA,50,,12311.41
31/01/2020,FPO,TRISTRAMS,1585,,12361.41
31/01/2020,DD,UCU B ACCOUNT,24.76,,13946.41
31/01/2020,BGC,SWANSEA UNI - PAY,,3288.72,13971.17
30/01/2020,BGC,UNIV OF NOTTINGHAM,,3412.29,10682.45
29/01/2020,BP,SAVE THE CHANGE,0.11,,7270.16
28/01/2020,DEB,AMZNMktplace,65.89,,7270.27
28/01/2020,DD,TALKTALK LIMITED,19.95,,7336.16
27/01/2020,FPO,BORIS REMOVALS,600,,7356.11
27/01/2020,BP,SAVE THE CHANGE,0.35,,7956.11
27/01/2020,DEB,GRAPE TREE,27.66,,7956.46
27/01/2020,DEP,LOYD 802 OXFORD ST,,35.6,7984.12
27/01/2020,CPT,LOYD LOYD 802 OXFO,40,,7948.52
24/01/2020,DEB,Audible UK,7.99,,7988.52
24/01/2020,CPT,LNK TESCO FABIAN W,40,,7996.51
24/01/2020,BP,SAVE THE CHANGE,0.48,,8036.51
24/01/2020,BGC,CARDIFF MET EX A/C,,22.2,8036.99
23/01/2020,DEB,TESCO STORES 4628,5.52,,8014.79
22/01/2020,DD,CORGI HOMEPLAN,18,,8020.31
21/01/2020,BP,SAVE THE CHANGE,0.2,,8038.31
20/01/2020,DEB,MOWGLI STREET FOOD,35.8,,8038.51
20/01/2020,FPO,TRISTRAMS LETTINGS,190,,8074.31
20/01/2020,BP,SAVE THE CHANGE,0.02,,8264.31
20/01/2020,CPT,LNK 49-51 CLUMBER,40,,8264.33
20/01/2020,DEB,BUNNEYS BIKES LIMI,21.98,,8304.33
17/01/2020,BP,SAVE THE CHANGE,0.9,,8326.31
16/01/2020,DEB,TFW RAIL SERVICES,98.2,,8327.21
16/01/2020,DEB,TESCO STORES 5660,34.9,,8425.41
16/01/2020,DD,O2,18.55,,8460.31
15/01/2020,CPT,LNK ARRIVA TRAINS,40,,8478.86
15/01/2020,BP,SAVE THE CHANGE,0.01,,8518.86
14/01/2020,DEB,AMZNMktplace,9.99,,8518.87
14/01/2020,BP,SAVE THE CHANGE,0.24,,8528.86
13/01/2020,DEB,WM MORRISONS STORE,15.8,,8529.1
13/01/2020,DEB,T K MAXX,13.96,,8544.9
13/01/2020,CPT,LNK SAINSBURYS BAN,80,,8558.86
13/01/2020,CPT,LNK PO THE CITYOFS,50,,8638.86
10/01/2020,DEB,Audible UK,18,,8688.86
10/01/2020,CPT,LNK TESCO FABIAN W,40,,8706.86
10/01/2020,BP,SAVE THE CHANGE,0.95,,8746.86
09/01/2020,DEB,Amazon.co.uk*4L6WG,63.1,,8747.81
09/01/2020,DEB,AMZNMktplace,19.99,,8810.91
09/01/2020,DEB,Amazon.co.uk*AJ1IW,18.96,,8830.9
09/01/2020,BP,SAVE THE CHANGE,0.03,,8849.86
08/01/2020,DEB,HOWELLS SOLICITORS,180,,8849.89
08/01/2020,DEB,AMZNMktplace,3.97,,9029.89
08/01/2020,CPT,LOYD LOYD 802 OXFO,40,,9033.86
08/01/2020,BP,SAVE THE CHANGE,0.13,,9073.86
07/01/2020,DEB,AIRBNB * HM9YBKEXN,469.87,,9073.99
07/01/2020,DD,THE GYM LTD,14.99,,9543.86
06/01/2020,BP,SAVE THE CHANGE,0.46,,9558.85
06/01/2020,CPT,LNK M&S SWANSEA,50,,9559.31
03/01/2020,DEP,CLUB LLOYDS WAIVED,,3,9609.31
03/01/2020,PAY,CLUB LLOYDS FEE,3,,9606.31
03/01/2020,DEB,NON-GBP PURCH FEE,0.5,,9609.31
03/01/2020,DEB,NON-GBP TRANS FEE,2.22,,9609.81
03/01/2020,DEB,ATHLEAN-X,74.54,,9612.03
03/01/2020,DD,ZURICH,24.82,,9686.57
02/01/2020,,INTEREST (GROSS),,5.05,9711.39
02/01/2020,DD,SANTANDER MORTGAGE,959.09,,9706.34
02/01/2020,DD,CC SWANSEA C.TAX,147,,10665.43
02/01/2020,DD,GOOD ENERGY LTD,50,,10812.43
02/01/2020,DD,DWR CYMRU W WATER,32.5,,10862.43
02/01/2020,SO,ESAVINGS ACCOUNT,300,,10894.93
02/01/2020,BP,SAVE THE CHANGE,0.5,,11194.93
02/01/2020,DEB,NOSDA STUDIO HOSTE,24.9,,11195.43
31/12/2019,DEB,Electrolux plc,130,,11220.33
31/12/2019,DEB,WILKO RETAIL LIMIT,3.6,,11350.33
31/12/2019,DEB,GREGGS PLC,2,,11353.93
31/12/2019,DD,UCU B ACCOUNT,24.76,,11355.93
31/12/2019,DD,TALKTALK LIMITED,19.95,,11380.69
31/12/2019,BGC,SWANSEA UNI - PAY,,3289.12,11400.64
30/12/2019,CPT,LNK SWANSEA CITY C,50,,8111.52
30/12/2019,CPT,LNK M&S SWANSEA,40,,8161.52
27/12/2019,BP,SAVE THE CHANGE,0.01,,8201.52
27/12/2019,BGC,GOOGLE IRELAND,,63.7,8201.53
24/12/2019,DEB,SAINSBURYS S/MKTS,13,,8137.83
24/12/2019,DEB,Audible UK,7.99,,8150.83
24/12/2019,BP,SAVE THE CHANGE,2.47,,8158.82
23/12/2019,DEB,Brontosaurus Vegan,27.14,,8161.29
23/12/2019,DEB,Amazon.co.uk*834HJ,15.54,,8188.43
23/12/2019,DEB,TURKISH LTD 311058,13.35,,8203.97
23/12/2019,DEB,MARKS&SPENCER PLC,4.5,,8217.32
23/12/2019,DD,HARLANDS,25,,8221.82
23/12/2019,DD,CORGI HOMEPLAN,18,,8246.82
23/12/2019,BP,SAVE THE CHANGE,0.91,,8264.82
23/12/2019,DEB,AMZNMktplace,3.45,,8265.73
23/12/2019,CPT,LNK M&S SWANSEA,50,,8269.18
23/12/2019,DEB,GODADDY.COM EUROPE,38.64,,8319.18
23/12/2019,DEB,IZ *Yogaya CIC,53,,8357.82
23/12/2019,FPO,AMELIA TERESZKIEWI,35,,8410.82
19/12/2019,BP,SAVE THE CHANGE,0.8,,8445.82
18/12/2019,DEB,TFW RAIL SERVICES,12.2,,8446.62
17/12/2019,CPT,LNK QUEEN STREET,20,,8458.82
16/12/2019,DD,O2,18.39,,8478.82
16/12/2019,BP,SAVE THE CHANGE,1.81,,8497.21
16/12/2019,DEB,Brontosaurus Vegan,15.65,,8499.02
16/12/2019,DEB,MARKS&SPENCER PLC,4.7,,8514.67
16/12/2019,FPO,CRYSTAL CLEAR,20,,8519.37
13/12/2019,DEB,AMZNMKTPLACE AMAZO,2.81,,8539.37
13/12/2019,DEB,AMAZON.CO.UK*CQ7LW,5.03,,8542.18
13/12/2019,CPT,LNK FULTON HOUSE,50,,8547.21
13/12/2019,BGC,SWANSEA UNIVERSITY,,2628.14,8597.21
11/12/2019,DEB,TESCO STORES 4628,3,,5969.07
10/12/2019,CPT,LNK TESCO FABIAN W,40,,5972.07
09/12/2019,DD,THE GYM LTD,14.99,,6012.07
09/12/2019,BP,SAVE THE CHANGE,1.39,,6027.06
09/12/2019,DEB,Brontosaurus Vegan,18.62,,6028.45
09/12/2019,DEB,MARKS&SPENCER PLC,2.5,,6047.07
09/12/2019,DEB,VIRGIN MEDIA PYMTS,96.5,,6049.57
09/12/2019,DEB,AMAZON.CO.UK*0P5YW,8.99,,6146.07
09/12/2019,CPT,LNK M&S SWANSEA,40,,6155.06
06/12/2019,CPT,LNK TESCO FABIAN W,40,,6195.06
06/12/2019,BP,SAVE THE CHANGE,0.24,,6235.06
06/12/2019,BGC,SHAREDEALING HSDL,,2.49,6235.3
05/12/2019,DEB,AMAZON.CO.UK*JX94J,9.76,,6232.81
04/12/2019,DEB,TESCO STORES 4628,2,,6242.57
03/12/2019,DEP,CLUB LLOYDS WAIVED,,3,6244.57
03/12/2019,PAY,CLUB LLOYDS FEE,3,,6241.57
03/12/2019,DD,ZURICH,24.82,,6244.57
02/12/2019,,INTEREST (GROSS),,4.5,6269.39
02/12/2019,CPT,LNK FABIAN WAY,50,,6264.89
02/12/2019,DD,SANTANDER MORTGAGE,959.09,,6314.89
02/12/2019,DD,CC SWANSEA C.TAX,147,,7273.98
02/12/2019,DD,GOOD ENERGY LTD,50,,7420.98
02/12/2019,DD,DWR CYMRU W WATER,32.5,,7470.98
02/12/2019,SO,ESAVINGS ACCOUNT,300,,7503.48
02/12/2019,BP,SAVE THE CHANGE,1.81,,7803.48
02/12/2019,DEB,WILKO RETAIL LIMIT,22.4,,7805.29
02/12/2019,DEB,MARKS&SPENCER PLC,7.2,,7827.69
02/12/2019,DEB,SAINSBURYS S/MKTS,40.9,,7834.89
02/12/2019,CPT,LNK M&S SWANSEA,50,,7875.79
29/11/2019,DEB,AMZNMktplace,13.99,,7925.79
29/11/2019,DEB,COFFEE NO 1 SWANSE,6.7,,7939.78
29/11/2019,DD,UCU B ACCOUNT,24.76,,7946.48
29/11/2019,BGC,SWANSEA UNI - PAY,,3289.12,7971.24
29/11/2019,BGC,SWANSEA UNIVERSITY,,190.5,4682.12
28/11/2019,FPO,AMELIA TERESZKIEWI,15,,4491.62
28/11/2019,CPT,LNK M&S SWANSEA,40,,4506.62
28/11/2019,FPO,SALLY GOLDSTONE,28,,4546.62
27/11/2019,DEB,THE BIKE HUB,35,,4574.62
27/11/2019,DD,TALKTALK LIMITED,19.95,,4609.62
27/11/2019,BGC,SHAREDEALING HSDL,,200,4629.57
25/11/2019,DD,HARLANDS,25,,4429.57
25/11/2019,BP,SAVE THE CHANGE,0.63,,4454.57
25/11/2019,DEB,Brontosaurus Vegan,24.39,,4455.2
25/11/2019,DEB,THE BIKE HUB,20,,4479.59
25/11/2019,DEB,Brontosaurus Vegan,14.99,,4499.59
25/11/2019,DEB,Audible UK,7.99,,4514.58
25/11/2019,CPT,LOYD LOYD 802 OXFO,50,,4522.57
22/11/2019,CPT,LNK TESCO FABIAN W,20,,4572.57
22/11/2019,DD,CORGI HOMEPLAN,18,,4592.57
22/11/2019,BGC,SWANSEA UNIVERSITY,,186.29,4610.57
20/11/2019,CPT,LNK TESCO FABIAN W,40,,4424.28
20/11/2019,BP,SAVE THE CHANGE,0.96,,4464.28
19/11/2019,DEB,AMZNMktplace,3.04,,4465.24
18/11/2019,DD,O2,38.42,,4468.28
18/11/2019,BP,SAVE THE CHANGE,1.7,,4506.7
18/11/2019,DEB,Brontosaurus Vegan,41.18,,4508.4
18/11/2019,DEB,MARKS&SPENCER PLC,7.12,,4549.58
18/11/2019,CPT,LNK M&S SWANSEA,40,,4556.7
15/11/2019,FPO,AMELIA TERESZKIEWI,20,,4596.7
15/11/2019,CPT,LNK FULTON HOUSE,40,,4616.7
15/11/2019,BGC,UNII OF BHAM INST,,115.6,4656.7
14/11/2019,FPO,REMUS,27.37,,4541.1
13/11/2019,CPT,LNK TESCO FABIAN W,50,,4568.47
12/11/2019,BP,SAVE THE CHANGE,0.2,,4618.47
11/11/2019,DEB,ANOKI LTD,50.8,,4618.67
11/11/2019,CPT,LNK 36 CLUMBER STR,40,,4669.47
07/11/2019,DD,THE GYM LTD,14.99,,4709.47
07/11/2019,BP,SAVE THE CHANGE,3.45,,4724.46
06/11/2019,DEB,TFW RAIL SERVICES,138.25,,4727.91
06/11/2019,DEB,TESCO STORES 6213,25.6,,4866.16
06/11/2019,DEB,UBER TRIP HELP.UBE,9.16,,4891.76
06/11/2019,DEB,UBER TRIP HELP.UBE,8.04,,4900.92
06/11/2019,DEB,UBER TRIP HELP.UBE,3.5,,4908.96
04/11/2019,DEP,CLUB LLOYDS WAIVED,,3,4912.46
04/11/2019,PAY,CLUB LLOYDS FEE,3,,4909.46
04/11/2019,BP,SAVE THE CHANGE,1.62,,4912.46
04/11/2019,DEB,Brontosaurus Vegan,27.22,,4914.08
04/11/2019,DEB,IZ *EZY VEGAN LTD,9.5,,4941.3
04/11/2019,CPT,LNK M&S SWANSEA,50,,4950.8
04/11/2019,DEP,LOYD 802 OXFORD ST,,45.75,5000.8
04/11/2019,CPT,LNK M&S SWANSEA,50,,4955.05
01/11/2019,,INTEREST (GROSS),,4.78,5005.05
01/11/2019,DEB,NON-GBP PURCH FEE,0.5,,5000.27
01/11/2019,DEB,NON-GBP TRANS FEE,1.27,,5000.77
01/11/2019,DEB,DELTA AIR   Baggag,42.66,,5002.04
01/11/2019,CPT,LNK TESCO FABIAN W,50,,5044.7
01/11/2019,DD,SANTANDER MORTGAGE,959.09,,5094.7
01/11/2019,DD,CC SWANSEA C.TAX,147,,6053.79
01/11/2019,DD,GOOD ENERGY LTD,50,,6200.79
01/11/2019,DD,DWR CYMRU W WATER,32.5,,6250.79
01/11/2019,DD,ZURICH,24.82,,6283.29
01/11/2019,SO,ESAVINGS ACCOUNT,300,,6308.11
31/10/2019,DD,UCU B ACCOUNT,24.76,,6608.11
31/10/2019,BP,SAVE THE CHANGE,0.81,,6632.87
31/10/2019,BGC,SWANSEA UNI - PAY,,3289.12,6633.68
30/10/2019,FPO,SALLY GOLDSTONE,550,,3344.56
30/10/2019,DEB,NON-GBP PURCH FEE,0.5,,3894.56
30/10/2019,DEB,NON-GBP TRANS FEE,33.1,,3895.06
30/10/2019,DEB,PINNACLE VANCOUVER,1107.19,,3928.16
28/10/2019,DD,TALKTALK LIMITED,20.61,,5035.35
28/10/2019,DEB,FOREIGN CASH FEE,1.5,,5055.96
28/10/2019,DEB,PROSPECT POINT BAR,68.98,,5057.46
25/10/2019,BP,SAVE THE CHANGE,0.01,,5126.44
25/10/2019,BGC,SWANSEA UNIVERSITY,,923.05,5126.45
24/10/2019,DEB,Audible.co.uk,7.99,,4203.4
23/10/2019,DD,HARLANDS,25,,4211.39
23/10/2019,BP,SAVE THE CHANGE,0.67,,4236.39
22/10/2019,DEB,NON-GBP PURCH FEE,0.5,,4237.06
22/10/2019,DEB,NON-GBP TRANS FEE,2.96,,4237.56
22/10/2019,DEB,RONSONS #102,99.33,,4240.52
22/10/2019,DD,CORGI HOMEPLAN,18,,4339.85
22/10/2019,BP,SAVE THE CHANGE,2.09,,4357.85
21/10/2019,DEB,NON-GBP CASH FEE,1.5,,4359.94
21/10/2019,DEB,NON-GBP TRANS FEE,5.31,,4361.44
21/10/2019,DEB,*VANCOUVER CBC & M,177.86,,4366.75
21/10/2019,DEB,NON-GBP PURCH FEE,0.5,,4544.61
21/10/2019,DEB,NON-GBP TRANS FEE,4.68,,4545.11
21/10/2019,DEB,PINNACLE VANCOUVER,156.74,,4549.79
21/10/2019,DEB,NON-GBP PURCH FEE,0.5,,4706.53
21/10/2019,DEB,NON-GBP TRANS FEE,0.25,,4707.03
21/10/2019,DEB,BLAZE PIZZA,8.5,,4707.28
21/10/2019,DEB,BREKA BAKERY & CAF,2.62,,4715.78
21/10/2019,DEB,NON-GBP PURCH FEE,0.5,,4718.4
21/10/2019,DEB,NON-GBP TRANS FEE,1.04,,4718.9
21/10/2019,DEB,AMTRAK  292795,35.05,,4719.94
21/10/2019,DEB,KLM UNITEDKI074823,43,,4754.99
21/10/2019,TFR,F/FLOW KING ABDULL,,216.93,4797.99
21/10/2019,DD,VIRGIN MEDIA PYMTS,44.5,,4581.06
21/10/2019,BP,SAVE THE CHANGE,3.49,,4625.56
21/10/2019,DEB,NON-GBP PURCH FEE,0.5,,4629.05
21/10/2019,DEB,NON-GBP TRANS FEE,0.81,,4629.55
21/10/2019,DEB,OLD NAVY 4218,27.21,,4630.36
21/10/2019,DEB,NON-GBP PURCH FEE,0.5,,4657.57
21/10/2019,DEB,NON-GBP TRANS FEE,0.55,,4658.07
21/10/2019,DEB,UBER   TRIP,18.52,,4658.62
21/10/2019,DEB,NON-GBP PURCH FEE,0.5,,4677.14
21/10/2019,DEB,NON-GBP TRANS FEE,1.32,,4677.64
21/10/2019,DEB,DHERGANE FARAH,44.4,,4678.96
21/10/2019,DEB,TFW RAIL SERVICES,50.4,,4723.36
21/10/2019,DEB,M&S SIMPLY FOOD SS,6.4,,4773.76
18/10/2019,DEB,AIRBNB * HMABB9424,705.58,,4780.16
18/10/2019,BP,SAVE THE CHANGE,0.02,,5485.74
17/10/2019,DEB,Audible.co.uk,18,,5485.76
17/10/2019,DEB,AMZNMktplace,11.99,,5503.76
17/10/2019,DEB,AMZNMKTPLACE AMAZO,11.99,,5515.75
17/10/2019,BP,SAVE THE CHANGE,0.23,,5527.74
16/10/2019,DEB,TURKISH LTD 311058,12.77,,5527.97
16/10/2019,CHQ,54,35,,5540.74
16/10/2019,DD,O2,18.39,,5575.74
16/10/2019,BP,SAVE THE CHANGE,0.2,,5594.13
15/10/2019,DEB,AMZNMktplace,6.8,,5594.33
15/10/2019,CPT,LNK TESCO FABIAN W,50,,5601.13
14/10/2019,BP,SAVE THE CHANGE,1.15,,5651.13
14/10/2019,DEB,Brontosaurus Vegan,14.35,,5652.28
14/10/2019,DEB,MARKS&SPENCER PLC,4.7,,5666.63
14/10/2019,CPT,LNK M&S SWANSEA,50,,5671.33
11/10/2019,DEB,TFW RAIL SERVICES,103.8,,5721.33
10/10/2019,BP,SAVE THE CHANGE,0.11,,5825.13
09/10/2019,DEB,Amazon.co.uk*MO5VX,7.89,,5825.24
09/10/2019,CPT,LNK TESCO FABIAN W,50,,5833.13
08/10/2019,BP,SAVE THE CHANGE,0.08,,5883.13
07/10/2019,DEB,AMZNMktplace,8.92,,5883.21
07/10/2019,DD,HARLANDS,25,,5892.13
07/10/2019,DD,THE GYM LTD,14.99,,5917.13
07/10/2019,BP,SAVE THE CHANGE,1.54,,5932.12
07/10/2019,DEB,WILKO RETAIL LIMIT,21.25,,5933.66
07/10/2019,DEB,MARKS&SPENCER PLC,11.71,,5954.91
07/10/2019,DEB,SAINSBURYS S/MKTS,13.5,,5966.62
07/10/2019,FPO,AMELIA TERESZKIEWI,20,,5980.12
04/10/2019,DEB,TESCO STORES 4628,5,,6000.12
04/10/2019,CPT,LNK TESCO FABIAN W,40,,6005.12
03/10/2019,DEB,THE BIKE HUB,30,,6045.12
02/10/2019,DEP,CLUB LLOYDS WAIVED,,3,6075.12
02/10/2019,PAY,CLUB LLOYDS FEE,3,,6072.12
02/10/2019,CPT,LNK SWANSEA CITY C,50,,6075.12
02/10/2019,BP,SAVE THE CHANGE,0.2,,6125.12
01/10/2019,,INTEREST (GROSS),,5.78,6125.32
01/10/2019,DEB,PETER ALAN RESIDEN,178.8,,6119.54
01/10/2019,DD,SANTANDER MORTGAGE,959.09,,6298.34
01/10/2019,DD,CC SWANSEA C.TAX,147,,7257.43
01/10/2019,DD,GOOD ENERGY LTD,50,,7404.43
01/10/2019,DD,DWR CYMRU W WATER,32.5,,7454.43
01/10/2019,DD,ZURICH,24.82,,7486.93
01/10/2019,SO,ESAVINGS ACCOUNT,300,,7511.75
30/09/2019,DD,UCU B ACCOUNT,24.76,,7811.75
30/09/2019,BP,SAVE THE CHANGE,2.48,,7836.51
30/09/2019,BGC,SWANSEA UNI - PAY,,3311.76,7838.99
30/09/2019,DEB,Brontosaurus Vegan,21.77,,4527.23
30/09/2019,DEB,MARKS&SPENCER PLC,7.1,,4549
30/09/2019,DEB,SAINSBURYS S/MKTS,22.5,,4556.1
30/09/2019,CPT,LNK M&S SWANSEA,50,,4578.6
27/09/2019,DEB,TURKISH LTD 311058,13.15,,4628.6
27/09/2019,CPT,LNK TESCO FABIAN W,30,,4641.75
25/09/2019,CPT,LNK TESCO FABIAN W,50,,4671.75
25/09/2019,BP,SAVE THE CHANGE,0.01,,4721.75
24/09/2019,DEB,Audible.co.uk,7.99,,4721.76
24/09/2019,BP,SAVE THE CHANGE,0.3,,4729.75
23/09/2019,DEB,Audible.co.uk,18,,4730.05
23/09/2019,DEB,MARKS&SPENCER PLC,4.7,,4748.05
23/09/2019,DEB,URBANZENINSTRUCTOR,7,,4752.75
23/09/2019,CHQ,53,500,,4759.75
23/09/2019,DD,VIRGIN MEDIA PYMTS,36.8,,5259.75
23/09/2019,DD,CORGI HOMEPLAN,14.75,,5296.55
23/09/2019,BP,SAVE THE CHANGE,0.63,,5311.3
23/09/2019,DEB,Brontosaurus Vegan,10.79,,5311.93
23/09/2019,CPT,LNK PO THE CITYOFS,50,,5322.72
20/09/2019,DEB,AMZNMktplace,30.58,,5372.72
20/09/2019,BP,SAVE THE CHANGE,0.25,,5403.3
20/09/2019,BGC,UNIV OF NOTTINGHAM,,186.29,5403.55
19/09/2019,DEB,NON-GBP PURCH FEE,0.5,,5217.26
19/09/2019,DEB,NON-GBP TRANS FEE,1.36,,5217.76
19/09/2019,DEB,NAME-CHEAP.COM,45.75,,5219.12
19/09/2019,BP,SAVE THE CHANGE,0.05,,5264.87
18/09/2019,DEB,WWW.FREEDOM-LEISUR,5.95,,5264.92
17/09/2019,DEB,ODEON UPT,10,,5270.87
17/09/2019,TFR,F/FLOW AARHUS UNIV,,250.31,5280.87
16/09/2019,CPT,LNK TESCO FABIAN W,50,,5030.56
16/09/2019,DD,O2,23.38,,5080.56
16/09/2019,BP,SAVE THE CHANGE,1.76,,5103.94
16/09/2019,DEB,Brontosaurus Vegan,13.28,,5105.7
16/09/2019,DEB,SPORTSDIRECT 141,41.99,,5118.98
16/09/2019,DEB,Brontosaurus Vegan,13.04,,5160.97
13/09/2019,DEB,AMZNMktplace,9.99,,5174.01
13/09/2019,DEB,AMZNMKTPLACE AMAZO,9.99,,5184
13/09/2019,DEB,WWW.FREEDOM-LEISUR,5.95,,5193.99
13/09/2019,CPT,LOYD LOYD 802 OXFO,80,,5199.94
13/09/2019,BP,SAVE THE CHANGE,0.45,,5279.94
12/09/2019,DEB,SAINSBURYS S/MKTS,28.55,,5280.39
12/09/2019,BP,SAVE THE CHANGE,0.1,,5308.94
11/09/2019,DEB,WWW.FREEDOM-LEISUR,5.95,,5309.04
11/09/2019,DEB,Amazon.co.uk*MA0PV,0.95,,5314.99
11/09/2019,BP,SAVE THE CHANGE,0.9,,5315.94
10/09/2019,DEB,TESCO STORES 5957,6.1,,5316.84
10/09/2019,CPT,LNK TESCO FABIAN W,50,,5322.94
10/09/2019,BP,SAVE THE CHANGE,1.34,,5372.94
09/09/2019,DEB,ORCHARD HOTEL,89,,5374.28
09/09/2019,DEB,TFW RAIL SERVICES,84.2,,5463.28
09/09/2019,DEB,AMZNMktplace,9.97,,5547.48
09/09/2019,DEB,WH SMITH,6.49,,5557.45
09/09/2019,DEB,POUNDLAND LTD 1414,4,,5563.94
09/09/2019,DEB,Audible.co.uk,18,,5567.94
09/09/2019,DD,THE GYM LTD,14.99,,5585.94
09/09/2019,BP,SAVE THE CHANGE,0.51,,5600.93
09/09/2019,DEB,MARKS&SPENCER PLC,12.5,,5601.44
09/09/2019,DEB,MARKS&SPENCER PLC,11,,5613.94
09/09/2019,CPT,LNK M&S SWANSEA,50,,5624.94
06/09/2019,DEB,AMZNMKTPLACE AMAZO,10.99,,5674.94
06/09/2019,CPT,LNK TESCO FABIAN W,50,,5685.93
05/09/2019,BP,SAVE THE CHANGE,0.75,,5735.93
04/09/2019,DEB,SAINSBURYS S/MKTS,13.55,,5736.68
04/09/2019,DEB,WWW.FREEDOM-LEISUR,5.95,,5750.23
04/09/2019,DEB,AMZNMktplace,2.75,,5756.18
04/09/2019,CPT,LNK TESCO FABIAN W,50,,5758.93
04/09/2019,BP,SAVE THE CHANGE,0.19,,5808.93
03/09/2019,DEP,CLUB LLOYDS WAIVED,,3,5809.12
03/09/2019,PAY,CLUB LLOYDS FEE,3,,5806.12
03/09/2019,DEB,WWW.III.CO.UK DE,1000,,5809.12
03/09/2019,DEB,AMZNMktplace,2.81,,6809.12
03/09/2019,BP,SAVE THE CHANGE,0.4,,6811.93
02/09/2019,,INTEREST (GROSS),,6.53,6812.33
02/09/2019,FPI,E JAKUBOWSKA,,15,6805.8
02/09/2019,DEB,M&S SIMPLY FOOD SS,9.6,,6790.8
02/09/2019,DD,SANTANDER MORTGAGE,1018.45,,6800.4
02/09/2019,DD,CC SWANSEA C.TAX,147,,7818.85
02/09/2019,DD,GOOD ENERGY LTD,50,,7965.85
02/09/2019,DD,DWR CYMRU W WATER,32.5,,8015.85
02/09/2019,DD,ZURICH,20.69,,8048.35
02/09/2019,SO,ESAVINGS ACCOUNT,300,,8069.04
30/08/2019,DD,UCU B ACCOUNT,24.26,,8369.04
30/08/2019,BGC,SWANSEA UNI - PAY,,3311.76,8393.3
28/08/2019,DEB,FOREIGN CASH FEE,1.5,,5081.54
28/08/2019,DEB,CALLE CATALUNA 4,207.55,,5083.04
28/08/2019,DEB,REVOLUT*7996*,10,,5290.59
27/08/2019,BP,SAVE THE CHANGE,3.08,,5300.59
27/08/2019,DEB,NON-GBP PURCH FEE,0.5,,5303.67
27/08/2019,DEB,NON-GBP TRANS FEE,8.51,,5304.17
27/08/2019,DEB,AMISTAT ISLAND HOS,284.75,,5312.68
27/08/2019,DEB,WWW.III.CO.UK DE,500,,5597.43
27/08/2019,DEB,WWW.III.CO.UK DE,500,,6097.43
27/08/2019,DEB,TFW RAIL SERVICES,50.4,,6597.43
27/08/2019,DEB,BRS WDF MAIN,20.83,,6647.83
27/08/2019,DEB,M&S SIMPLY FOOD SS,8,,6668.66
27/08/2019,DEB,STARBUCKS COFFEE C,4.05,,6676.66
27/08/2019,DEB,Audible.co.uk,7.99,,6680.71
27/08/2019,DEB,SWANSEA UNI - CATE,4.65,,6688.7
27/08/2019,TFR,R LAWRENCE  24AUG19,,500,6693.35
23/08/2019,DEB,ZINCO LOUNGE,21.25,,6193.35
23/08/2019,CPT,LNK FABIAN WAY,50,,6214.6
22/08/2019,DD,CORGI HOMEPLAN,14.75,,6264.6
22/08/2019,BP,SAVE THE CHANGE,0.05,,6279.35
21/08/2019,DEB,WWW.FREEDOM-LEISUR,5.95,,6279.4
21/08/2019,DEB,URBANZENINSTRUCTOR,7,,6285.35
21/08/2019,CPT,LNK M&S SWANSEA,60,,6292.35
21/08/2019,DD,VIRGIN MEDIA PYMTS,29,,6352.35
21/08/2019,BP,SAVE THE CHANGE,0.54,,6381.35
20/08/2019,DEB,AMZNMktplace,19.97,,6381.89
20/08/2019,DEB,AMZNMKTPLACE AMAZO,12.99,,6401.86
20/08/2019,DEB,TESCO STORES 4628,6.5,,6414.85
20/08/2019,BP,SAVE THE CHANGE,1.11,,6421.35
19/08/2019,DEB,WWW.III.CO.UK DE,900,,6422.46
19/08/2019,DEB,Audible.co.uk,4.41,,7322.46
19/08/2019,DEB,SCANDIC AARHUS CIT,21.48,,7326.87
19/08/2019,BP,SAVE THE CHANGE,5.74,,7348.35
19/08/2019,CPT,LNK 90146901 SA1 G,40,,7354.09
19/08/2019,DEB,NON-GBP PURCH FEE,0.5,,7394.09
19/08/2019,DEB,NON-GBP TRANS FEE,1.63,,7394.59
19/08/2019,DEB,AMISTATISLANDHOSTE,54.72,,7396.22
19/08/2019,DEB,NON-GBP PURCH FEE,0.5,,7450.94
19/08/2019,DEB,NON-GBP TRANS FEE,1.15,,7451.44
19/08/2019,DEB,MIB AARHUS LUFTHAV,38.72,,7452.59
19/08/2019,DEB,NON-GBP PURCH FEE,0.5,,7491.31
19/08/2019,DEB,NON-GBP TRANS FEE,0.42,,7491.81
19/08/2019,DEB,MIDTTRAFIK,14.18,,7492.23
19/08/2019,DEB,NON-GBP PURCH FEE,0.5,,7506.41
19/08/2019,DEB,NON-GBP TRANS FEE,0.33,,7506.91
19/08/2019,DEB,MIB AARHUS LUFTHAV,11.1,,7507.24
19/08/2019,DEB,NON-GBP PURCH FEE,0.5,,7518.34
19/08/2019,DEB,NON-GBP TRANS FEE,0.53,,7518.84
19/08/2019,DEB,TAXAS KUNDECENTER,18.01,,7519.37
19/08/2019,DEB,NON-GBP PURCH FEE,0.5,,7537.38
19/08/2019,DEB,NON-GBP TRANS FEE,0.4,,7537.88
19/08/2019,DEB,SHAKSHUKA,13.57,,7538.28
19/08/2019,DEB,NON-GBP PURCH FEE,0.5,,7551.85
19/08/2019,DEB,NON-GBP TRANS FEE,0.19,,7552.35
19/08/2019,DEB,DEEDEES ApS,6.41,,7552.54
16/08/2019,DEB,NON-GBP PURCH FEE,0.5,,7558.95
16/08/2019,DEB,NON-GBP TRANS FEE,0.42,,7559.45
16/08/2019,DEB,MIDTTRAFIK,14.26,,7559.87
16/08/2019,DEB,RADISSON BLU HOTEL,114.3,,7574.13
16/08/2019,DEB,AMZNMKTPLACE AMAZO,5.99,,7688.43
16/08/2019,DD,O2,23.38,,7694.42
16/08/2019,BP,SAVE THE CHANGE,1.22,,7717.8
16/08/2019,BGC,SWANSEA UNIVERSITY,,1695.55,7719.02
15/08/2019,DEB,TFW RAIL SERVICES,97.1,,6023.47
15/08/2019,DEB,Brontosaurus Vegan,12.99,,6120.57
15/08/2019,DEB,RYANAIR   224000,28.69,,6133.56
15/08/2019,BP,SAVE THE CHANGE,0.01,,6162.25
14/08/2019,DEB,RYANAIR   224000,29,,6162.26
14/08/2019,DEB,AMZNMktplace,16.99,,6191.26
14/08/2019,BP,SAVE THE CHANGE,0.11,,6208.25
13/08/2019,DEB,WWW.III.CO.UK DE,1100,,6208.36
13/08/2019,DEB,SAINSBURYS S/MKTS,16.9,,7308.36
13/08/2019,DEB,AMZNMktplace,9.99,,7325.26
13/08/2019,CPT,LNK TESCO FABIAN W,60,,7335.25
13/08/2019,BP,SAVE THE CHANGE,0.45,,7395.25
12/08/2019,TFR,R LAWRENCE,,1100,7395.7
12/08/2019,DEB,COFFEE#1 SWANSEA,8.55,,6295.7
12/08/2019,BP,SAVE THE CHANGE,4.55,,6304.25
12/08/2019,DEB,COFFEE#1 SWANSEA,11.85,,6308.8
12/08/2019,DEB,VALLEY MILL LTD,10.95,,6320.65
12/08/2019,DEB,MARKS&SPENCER PLC,9.7,,6331.6
12/08/2019,DEB,WILKO RETAIL LIMIT,8,,6341.3
12/08/2019,DEB,WILKO RETAIL LIMIT,6.5,,6349.3
12/08/2019,FPO,AMELIA TERESZKIEWI,35,,6355.8
12/08/2019,DEB,NON-GBP PURCH FEE,0.5,,6390.8
12/08/2019,DEB,NON-GBP TRANS FEE,0.19,,6391.3
12/08/2019,DEB,HMSHOST AMSTERDAM,6.52,,6391.49
12/08/2019,DEB,ZINCO LOUNGE,12.45,,6398.01
12/08/2019,DEB,AMZNMktplace,3.26,,6410.46
12/08/2019,DEB,AMZNMktplace,2.97,,6413.72
12/08/2019,DEB,AMZNMKTPLACE AMAZO,66.94,,6416.69
12/08/2019,CPT,LNK SWANSEA CITY C,50,,6483.63
12/08/2019,DEB,NON-GBP PURCH FEE,0.5,,6533.63
12/08/2019,DEB,NON-GBP TRANS FEE,1.38,,6534.13
12/08/2019,DEB,DELTA AIR   Baggag,46.3,,6535.51
09/08/2019,CPT,LNK TESCO FABIAN W,60,,6581.81
09/08/2019,DEB,NON-GBP PURCH FEE,0.5,,6641.81
09/08/2019,DEB,NON-GBP TRANS FEE,1.4,,6642.31
09/08/2019,DEB,NEWSLINK 16 BOS,47.01,,6643.71
08/08/2019,DEB,WWW.III.CO.UK DE,100,,6690.72
07/08/2019,DD,THE GYM LTD,14.99,,6790.72
07/08/2019,BP,SAVE THE CHANGE,0.53,,6805.71
06/08/2019,DEB,WWW.III.CO.UK DE,1000,,6806.24
06/08/2019,DEB,NON-GBP PURCH FEE,0.5,,7806.24
06/08/2019,DEB,NON-GBP TRANS FEE,1.06,,7806.74
06/08/2019,DEB,WHOLEFDS BLH 10091,35.47,,7807.8
05/08/2019,BP,SAVE THE CHANGE,0.44,,7843.27
05/08/2019,DEB,NON-GBP PURCH FEE,0.5,,7843.71
05/08/2019,DEB,NON-GBP TRANS FEE,1.16,,7844.21
05/08/2019,DEB,SHAWS #0677,38.88,,7845.37
02/08/2019,DEP,CLUB LLOYDS WAIVED,,3,7884.25
02/08/2019,PAY,CLUB LLOYDS FEE,3,,7881.25
02/08/2019,DEB,NON-GBP PURCH FEE,0.5,,7884.25
02/08/2019,DEB,NON-GBP TRANS FEE,0.7,,7884.75
02/08/2019,DEB,SAVERS - 1207,23.68,,7885.45
02/08/2019,BP,SAVE THE CHANGE,0.04,,7909.13
01/08/2019,,INTEREST (GROSS),,5.53,7909.17
01/08/2019,DD,CC SWANSEA C.TAX,147,,7903.64
01/08/2019,DD,GOOD ENERGY LTD,50,,8050.64
01/08/2019,DD,DWR CYMRU W WATER,32.5,,8100.64
01/08/2019,DD,ZURICH,20.69,,8133.14
01/08/2019,DEB,NON-GBP PURCH FEE,0.5,,8153.83
01/08/2019,DEB,NON-GBP TRANS FEE,0.98,,8154.33
01/08/2019,DEB,GAP US 822,32.96,,8155.31
01/08/2019,SO,ESAVINGS ACCOUNT,300,,8188.27
01/08/2019,BP,SAVE THE CHANGE,0.75,,8488.27
31/07/2019,DEB,DOUBLETREE BY HILT,101.25,,8489.02
31/07/2019,DD,UCU B ACCOUNT,24.26,,8590.27
31/07/2019,BP,SAVE THE CHANGE,0.6,,8614.53
31/07/2019,BGC,SWANSEA UNI - PAY,,3265.85,8615.13
30/07/2019,DEB,NON-GBP CASH FEE,1.5,,5349.28
30/07/2019,DEB,NON-GBP TRANS FEE,4.97,,5350.78
30/07/2019,DEB,*EASTERN AVENUE RE,166.24,,5355.75
30/07/2019,DEB,TFW RAIL SERVICES,50.4,,5521.99
30/07/2019,BP,SAVE THE CHANGE,0.99,,5572.39
29/07/2019,DEB,Brontosaurus Vegan,15.52,,5573.38
29/07/2019,DEB,AMZNMktplace,199.49,,5588.9
29/07/2019,DEB,URBANZENINSTRUCTOR,7,,5788.39
29/07/2019,CPT,LOYD LOYD 802 OXFO,50,,5795.39
26/07/2019,BP,SAVE THE CHANGE,1.61,,5845.39
26/07/2019,BGC,SWANSEA UNIVERSITY,,38.31,5847
25/07/2019,DEB,NON-GBP PURCH FEE,0.5,,5808.69
25/07/2019,DEB,NON-GBP TRANS FEE,0.69,,5809.19
25/07/2019,DEB,ASKCRAIG,23.34,,5809.88
25/07/2019,DEB,RYANAIR   224000,49.97,,5833.22
25/07/2019,DEB,NON-GBP PURCH FEE,0.5,,5883.19
25/07/2019,DEB,NON-GBP TRANS FEE,0.83,,5883.69
25/07/2019,DEB,RYANAIR   000000,28.08,,5884.52
25/07/2019,CPT,LNK TESCO FABIAN W,100,,5912.6
25/07/2019,BP,SAVE THE CHANGE,0.01,,6012.6
24/07/2019,DEB,Audible.co.uk,7.99,,6012.61
23/07/2019,BP,SAVE THE CHANGE,0.57,,6020.6
22/07/2019,DEB,T K MAXX,48.93,,6021.17
22/07/2019,DEB,AMZNMktplace,6.5,,6070.1
22/07/2019,DEB,URBANZENINSTRUCTOR,7,,6076.6
22/07/2019,TFR,F/FLOW GRINDEYS LL,,1069.68,6083.6
22/07/2019,DD,VIRGIN MEDIA PYMTS,29,,5013.92
22/07/2019,DD,CORGI HOMEPLAN,14.75,,5042.92
19/07/2019,FPO,AMELIA TERESZKIEWI,20,,5057.67
19/07/2019,CPT,LNK TESCO FABIAN W,50,,5077.67
19/07/2019,BGC,SWANSEA UNIVERSITY,,1868.98,5127.67
18/07/2019,BP,SAVE THE CHANGE,0.7,,3258.69
17/07/2019,DEB,SAINSBURYS S/MKTS,10.3,,3259.39
17/07/2019,BP,SAVE THE CHANGE,0.8,,3269.69
16/07/2019,FPO,CARL DAVENPORT,60,,3270.49
16/07/2019,DEB,AMAZON.CO.UK*MH023,36.2,,3330.49
16/07/2019,DD,O2,18.45,,3366.69
16/07/2019,BP,SAVE THE CHANGE,2.54,,3385.14
15/07/2019,DEB,Brontosaurus Vegan,18.07,,3387.68
15/07/2019,DEB,MARKS&SPENCER PLC,7.7,,3405.75
15/07/2019,DEB,Audible.co.uk,18,,3413.45
15/07/2019,DEB,ZINCO LOUNGE,7.65,,3431.45
15/07/2019,DEB,AMZNMktplace,3.04,,3439.1
15/07/2019,DEB,URBANZENINSTRUCTOR,7,,3442.14
15/07/2019,BP,SAVE THE CHANGE,0.97,,3449.14
15/07/2019,CPT,LNK 1 UNION STREET,200,,3450.11
12/07/2019,DEB,EASYJET   000EXG,298.48,,3650.11
12/07/2019,DEB,HOSTEL WORLD,61.55,,3948.59
11/07/2019,BP,SAVE THE CHANGE,0.15,,4010.14
10/07/2019,DEB,ZINCO LOUNGE,19.85,,4010.29
10/07/2019,BP,SAVE THE CHANGE,0.08,,4030.14
09/07/2019,DEB,AMZNMKTPLACE AMAZO,4.92,,4030.22
09/07/2019,CPT,LNK M&S SWANSEA,60,,4035.14
09/07/2019,BP,SAVE THE CHANGE,1.72,,4095.14
08/07/2019,DEB,TFW RAIL SERVICES,11.8,,4096.86
08/07/2019,DEB,AMZN Mktp UK*M635I,7.43,,4108.66
08/07/2019,DEB,SWANSEA UNI - CATE,8.05,,4116.09
08/07/2019,DD,THE GYM LTD,14.99,,4124.14
08/07/2019,BP,SAVE THE CHANGE,0.6,,4139.13
05/07/2019,DEB,AMZNMktplace,14.4,,4139.73
05/07/2019,CPT,LNK TESCO FABIAN W,100,,4154.13
05/07/2019,BP,SAVE THE CHANGE,0.19,,4254.13
04/07/2019,DEB,AMZNMKTPLACE AMAZO,1.81,,4254.32
03/07/2019,FPO,AMELIA TERESZKIEWI,40,,4256.13
03/07/2019,DEB,Amazon.co.uk*M60AR,9,,4296.13
03/07/2019,BGC,GOOGLE IRELAND,,82.04,4305.13
02/07/2019,DEP,CLUB LLOYDS WAIVED,,3,4223.09
02/07/2019,PAY,CLUB LLOYDS FEE,3,,4220.09
02/07/2019,DD,ZURICH,20.69,,4223.09
02/07/2019,BP,SAVE THE CHANGE,2.77,,4243.78
01/07/2019,,INTEREST (GROSS),,5.54,4246.55
01/07/2019,DEB,ZINCO LOUNGE,13.05,,4241.01
01/07/2019,DEB,ZARA SWANSEA,15.99,,4254.06
01/07/2019,DEB,COFFEE#1 SWANSEA,10.75,,4270.05
01/07/2019,DEB,TESCO STORE 3241,8.19,,4280.8
01/07/2019,DEB,MARKS&SPENCER PLC,1,,4288.99
01/07/2019,DEB,TFW RAIL SERVICES,77.5,,4289.99
01/07/2019,DEB,BIRMINGHAM INT HOT,58,,4367.49
01/07/2019,DEB,WASABI BIRMINGHAM,22.75,,4425.49
01/07/2019,DD,PRINCIPALITY BS,1163.58,,4448.24
01/07/2019,DD,CC SWANSEA C.TAX,147,,5611.82
01/07/2019,DD,GOOD ENERGY LTD,50,,5758.82
01/07/2019,DD,DWR CYMRU W WATER,32.5,,5808.82
01/07/2019,SO,ESAVINGS ACCOUNT,300,,5841.32
01/07/2019,BP,SAVE THE CHANGE,0.6,,6141.32
01/07/2019,CPT,LNK ESTATE AGENTS,50,,6141.92
01/07/2019,CPT,LNK SWANSEA 1,100,,6191.92
28/06/2019,DEB,WWW.III.CO.UK DE,1020,,6291.92
28/06/2019,DEB,ZINCO LOUNGE,14.4,,7311.92
28/06/2019,DD,UCU B ACCOUNT,24.26,,7326.32
28/06/2019,BP,SAVE THE CHANGE,0.2,,7350.58
28/06/2019,BGC,SWANSEA UNI - PAY,,3265.85,7350.78
28/06/2019,BGC,GOOGLE IRELAND,,0.45,4084.93
27/06/2019,DEB,WWW.III.CO.UK DE,2200,,4084.48
27/06/2019,DEB,TFW RAIL SERVICES,11.8,,6284.48
27/06/2019,BP,SAVE THE CHANGE,2.31,,6296.28
26/06/2019,DEB,Brontosaurus Vegan,25.34,,6298.59
26/06/2019,DEB,MARKS&SPENCER PLC,14.2,,6323.93
26/06/2019,DEB,AMZNMKTPLACE AMAZO,6.15,,6338.13
26/06/2019,TFR,R LAWRENCE,,2000,6344.28
25/06/2019,DEB,THE BIKE HUB,90,,4344.28
25/06/2019,CPT,LNK TESCO FABIAN W,40,,4434.28
25/06/2019,BP,SAVE THE CHANGE,1.09,,4474.28
24/06/2019,DEB,Amazon.co.uk*M62FO,56.03,,4475.37
24/06/2019,DEB,AMZNMktplace,24.94,,4531.4
24/06/2019,DEB,AMZNMktplace,19.95,,4556.34
24/06/2019,DEB,Audible.co.uk,7.99,,4576.29
24/06/2019,DD,CORGI HOMEPLAN,14.75,,4584.28
24/06/2019,BP,SAVE THE CHANGE,0.4,,4599.03
24/06/2019,CPT,LNK 1 UNION STREET,60,,4599.43
21/06/2019,DEB,SAINSBURY'S S/MKT,6.6,,4659.43
21/06/2019,CPT,LNK TESCO FABIAN W,60,,4666.03
21/06/2019,DD,VIRGIN MEDIA PYMTS,29,,4726.03
20/06/2019,DEB,WWW.III.CO.UK DE,4000,,4755.03
20/06/2019,CPT,LNK DIAMOND PROPER,80,,8755.03
20/06/2019,BP,SAVE THE CHANGE,0.33,,8835.03
19/06/2019,DEB,CANDLES & CO,21.99,,8835.36
19/06/2019,DEB,Audible.co.uk,18,,8857.35
19/06/2019,DEB,POST OFFICE COUNTE,16.68,,8875.35
19/06/2019,TFR,R LAWRENCE,,4000,8892.03
19/06/2019,BP,SAVE THE CHANGE,0.61,,4892.03
18/06/2019,DEB,AMZNMKTPLACE AMAZO,18.52,,4892.64
18/06/2019,DEB,Amazon.co.uk*M64R1,6.87,,4911.16
18/06/2019,BP,SAVE THE CHANGE,0.33,,4918.03
17/06/2019,DEB,Amazon.co.uk*M60D5,3.87,,4918.36
17/06/2019,DEB,LUL TICKET MACHINE,4.9,,4922.23
17/06/2019,DEB,TFW RAIL SERVICES,87.9,,4927.13
17/06/2019,DD,O2,22.58,,5015.03
17/06/2019,CPT,LOYD LOYD 802 OXFO,50,,5037.61
14/06/2019,CPT,LNK TESCO FABIAN W,120,,5087.61
13/06/2019,DEB,WWW.III.CO.UK DE,2600,,5207.61
12/06/2019,TFR,R LAWRENCE,,2800,7807.61
12/06/2019,BP,SAVE THE CHANGE,0.6,,5007.61
11/06/2019,DEB,WWW.III.CO.UK DE,2000,,5008.21
11/06/2019,DEB,NON-GBP PURCH FEE,0.5,,7008.21
11/06/2019,DEB,NON-GBP TRANS FEE,0.25,,7008.71
11/06/2019,DEB,TRAINAWAY APS,8.4,,7008.96
10/06/2019,TFR,R LAWRENCE,,2000,7017.36
10/06/2019,DEB,3830824-ONBB1,126,,5017.36
10/06/2019,CPT,LNK FABIAN WAY,50,,5143.36
10/06/2019,BP,SAVE THE CHANGE,0.61,,5193.36
10/06/2019,DEB,NON-GBP PURCH FEE,0.5,,5193.97
10/06/2019,DEB,NON-GBP TRANS FEE,0.25,,5194.47
10/06/2019,DEB,TRAINAWAY APS,8.39,,5194.72
07/06/2019,DEB,FOREIGN CASH FEE,1.5,,5203.11
07/06/2019,DEB,Shopping Domus Tri,197.37,,5204.61
07/06/2019,DD,THE GYM LTD,14.99,,5401.98
07/06/2019,BP,SAVE THE CHANGE,1.24,,5416.97
06/06/2019,DEB,NON-GBP PURCH FEE,0.5,,5418.21
06/06/2019,DEB,NON-GBP TRANS FEE,0.25,,5418.71
06/06/2019,DEB,TRAINAWAY APS,8.37,,5418.96
06/06/2019,DEB,NON-GBP PURCH FEE,0.5,,5427.33
06/06/2019,DEB,NON-GBP TRANS FEE,0.25,,5427.83
06/06/2019,DEB,TRAINAWAY APS,8.39,,5428.08
06/06/2019,BP,SAVE THE CHANGE,0.62,,5436.47
05/06/2019,DEB,NON-GBP PURCH FEE,0.5,,5437.09
05/06/2019,DEB,NON-GBP TRANS FEE,0.25,,5437.59
05/06/2019,DEB,TRAINAWAY APS,8.38,,5437.84
05/06/2019,BP,SAVE THE CHANGE,0.2,,5446.22
04/06/2019,DEP,CLUB LLOYDS WAIVED,,3,5446.42
04/06/2019,PAY,CLUB LLOYDS FEE,3,,5443.42
04/06/2019,DEB,MEIA DUZIA,12.8,,5446.42
04/06/2019,BP,SAVE THE CHANGE,2.34,,5459.22
03/06/2019,,INTEREST (GROSS),,6.48,5461.56
03/06/2019,DEB,NON-GBP PURCH FEE,0.5,,5455.08
03/06/2019,DEB,NON-GBP TRANS FEE,0.26,,5455.58
03/06/2019,DEB,RESTAURANTE DA TER,8.79,,5455.84
03/06/2019,DEB,NON-GBP PURCH FEE,0.5,,5464.63
03/06/2019,DEB,NON-GBP TRANS FEE,0.25,,5465.13
03/06/2019,DEB,TRAINAWAY APS,8.37,,5465.38
03/06/2019,DEB,TFW RAIL SERVICES,50.4,,5473.75
03/06/2019,DEB,MINIPRECO LOIOS 2,20.65,,5524.15
03/06/2019,DEB,M&S SIMPLY FOOD-SS,7.65,,5544.8
03/06/2019,DEB,WWW.III.CO.UK DE,1000,,5552.45
03/06/2019,DEB,SAINSBURY'S S/MKT,19.8,,6552.45
03/06/2019,DD,PRINCIPALITY BS,957.26,,6572.25
03/06/2019,DD,CC SWANSEA C.TAX,147,,7529.51
03/06/2019,DD,GOOD ENERGY LTD,50,,7676.51
03/06/2019,DD,DWR CYMRU W WATER,32.5,,7726.51
03/06/2019,DD,ZURICH,20.69,,7759.01
03/06/2019,SO,ESAVINGS ACCOUNT,300,,7779.7
31/05/2019,TFR,R LAWRENCE,,1000,8079.7
31/05/2019,DEB,WWW.III.CO.UK DE,200,,7079.7
31/05/2019,DD,UCU B ACCOUNT,24.26,,7279.7
31/05/2019,BGC,SWANSEA UNI - PAY,,3265.85,7303.96
30/05/2019,CPT,LNK TESCO FABIAN W,60,,4038.11
30/05/2019,BP,SAVE THE CHANGE,0.23,,4098.11
29/05/2019,DEB,AMZNMktplace,1.77,,4098.34
29/05/2019,CPT,LNK TESCO FABIAN W,40,,4100.11
29/05/2019,BP,SAVE THE CHANGE,2.27,,4140.11
28/05/2019,DEB,AMZNMktplace,12.49,,4142.38
28/05/2019,DEB,SWANSEA FOOD CENTR,7.46,,4154.87
28/05/2019,DEB,AMZNMKTPLACE AMAZO,3.33,,4162.33
28/05/2019,DEB,AMZN MKTP UK*MN36N,5.99,,4165.66
28/05/2019,DEB,WWW.III.CO.UK DE,5000,,4171.65
28/05/2019,DEB,POST OFFICE COUNTE,27.62,,9171.65
28/05/2019,DEB,Brontosaurus Vegan,16.95,,9199.27
28/05/2019,DEB,MARKS&SPENCER PLC,8.9,,9216.22
28/05/2019,DEB,AMAZON.CO.UK*MN9V3,12.99,,9225.12
28/05/2019,BP,SAVE THE CHANGE,0.01,,9238.11
28/05/2019,CPT,LNK M&S SWANSEA,50,,9238.12
28/05/2019,TFR,R LAWRENCE  25MAY19,,5000,9288.12
24/05/2019,CPT,LNK TESCO FABIAN W,50,,4288.12
24/05/2019,DEB,TESCO STORES 4628,5,,4338.12
24/05/2019,DEB,Audible.co.uk,7.99,,4343.12
24/05/2019,BP,SAVE THE CHANGE,1.48,,4351.11
23/05/2019,DEB,NON-GBP PURCH FEE,0.5,,4352.59
23/05/2019,DEB,NON-GBP TRANS FEE,15.82,,4353.09
23/05/2019,DEB,2160701-KEGHB,529.11,,4368.91
23/05/2019,DEB,AMZN MKTP UK*MN1H1,18.41,,4898.02
22/05/2019,CPT,LNK TESCO FABIAN W,50,,4916.43
22/05/2019,DD,CORGI HOMEPLAN,14.75,,4966.43
21/05/2019,DD,VIRGIN MEDIA PYMTS,29,,4981.18
21/05/2019,BP,SAVE THE CHANGE,2.5,,5010.18
20/05/2019,DEB,Amazon.co.uk*MN9ZF,16.33,,5012.68
20/05/2019,DEB,AMAZON.CO.UK*MN6LS,9.79,,5029.01
20/05/2019,DEB,Brontosaurus Vegan,29.18,,5038.8
20/05/2019,DEB,MARKS&SPENCER PLC,4.7,,5067.98
20/05/2019,DEB,SWANSEA UNI - CATE,13.5,,5072.68
20/05/2019,CPT,LNK TESCO FABIAN W,60,,5086.18
20/05/2019,CPT,LNK SWANSEA CITY C,50,,5146.18
17/05/2019,CPT,LNK TESCO FABIAN W,60,,5196.18
16/05/2019,DD,O2,27.14,,5256.18
16/05/2019,BP,SAVE THE CHANGE,0.49,,5283.32
15/05/2019,DEB,NON-GBP PURCH FEE,0.5,,5283.81
15/05/2019,DEB,NON-GBP TRANS FEE,0.31,,5284.31
15/05/2019,DEB,HMSHOST AMSTERDAM,10.51,,5284.62
15/05/2019,BP,SAVE THE CHANGE,1.27,,5295.13
14/05/2019,DEB,SAINSBURY'S S/MKT,9.9,,5296.4
14/05/2019,DEB,AMZNMKTPLACE AMAZO,2.32,,5306.3
14/05/2019,DEB,DOUBLETREE BY HILT,105,,5308.62
14/05/2019,CPT,LNK FABIAN WAY,50,,5413.62
14/05/2019,DEB,NON-GBP PURCH FEE,0.5,,5463.62
14/05/2019,DEB,NON-GBP TRANS FEE,0.28,,5464.12
14/05/2019,DEB,BAR BIGO,9.51,,5464.4
14/05/2019,BP,SAVE THE CHANGE,0.37,,5473.91
13/05/2019,DEB,NH GENOVA CENTRO,740.63,,5474.28
13/05/2019,DEB,NON-GBP CASH FEE,1.5,,6214.91
13/05/2019,DEB,NON-GBP TRANS FEE,2.58,,6216.41
13/05/2019,DEB,ABN-AMRO,86.45,,6218.99
13/05/2019,BP,SAVE THE CHANGE,0.39,,6305.44
10/05/2019,DEB,NON-GBP PURCH FEE,0.5,,6305.83
10/05/2019,DEB,NON-GBP TRANS FEE,0.61,,6306.33
10/05/2019,DEB,JAPAN RESTAURANT,20.61,,6306.94
10/05/2019,BP,SAVE THE CHANGE,0.69,,6327.55
09/05/2019,DEB,NON-GBP PURCH FEE,0.5,,6328.24
09/05/2019,DEB,NON-GBP TRANS FEE,0.76,,6328.74
09/05/2019,DEB,CELIO 6309,25.74,,6329.5
09/05/2019,DEB,NON-GBP PURCH FEE,0.5,,6355.24
09/05/2019,DEB,NON-GBP TRANS FEE,0.25,,6355.74
09/05/2019,DEB,H & M  5,8.57,,6355.99
08/05/2019,BP,SAVE THE CHANGE,2.51,,6364.56
07/05/2019,DEB,Amazon.co.uk*MN59F,6.29,,6367.07
07/05/2019,DEB,NON-GBP PURCH FEE,0.5,,6373.36
07/05/2019,DEB,NON-GBP TRANS FEE,0.84,,6373.86
07/05/2019,DEB,H & M  5,28.32,,6374.7
07/05/2019,DEB,NON-GBP CASH FEE,1.5,,6403.02
07/05/2019,DEB,NON-GBP TRANS FEE,5.13,,6404.52
07/05/2019,DEB,BANCA CARIGE CR GE,171.76,,6409.65
07/05/2019,DEB,TFW RAIL SERVICES,50.4,,6581.41
07/05/2019,DEB,AMZNMKTPLACE AMAZO,5.48,,6631.81
07/05/2019,DD,THE GYM LTD,14.99,,6637.29
03/05/2019,DD,ASSURANT INTER LTD,21.15,,6652.28
03/05/2019,BP,SAVE THE CHANGE,0.25,,6673.43
02/05/2019,DEP,CLUB LLOYDS WAIVED,,3,6673.68
02/05/2019,PAY,CLUB LLOYDS FEE,3,,6670.68
02/05/2019,DEB,Lush UK,16.95,,6673.68
02/05/2019,DEB,SAINSBURYS S/MKTS,16.8,,6690.63
02/05/2019,CPT,LNK TESCO FABIAN W,60,,6707.43
02/05/2019,BP,SAVE THE CHANGE,0.05,,6767.43
01/05/2019,,INTEREST (GROSS),,6.12,6767.48
01/05/2019,DEB,SAINSBURYS S/MKTS,15,,6761.36
01/05/2019,DEB,TESCO STORES 4628,3.95,,6776.36
01/05/2019,CPT,LNK SAINSBURYS BAN,50,,6780.31
01/05/2019,DD,PRINCIPALITY BS,957.26,,6830.31
01/05/2019,DD,CC SWANSEA C.TAX,147,,7787.57
01/05/2019,DD,GOOD ENERGY LTD,97,,7934.57
01/05/2019,DD,DWR CYMRU W WATER,32.5,,8031.57
01/05/2019,DD,ZURICH,20.69,,8064.07
01/05/2019,SO,ESAVINGS ACCOUNT,300,,8084.76
30/04/2019,DD,UCU B ACCOUNT,24.26,,8384.76
30/04/2019,BP,SAVE THE CHANGE,1.18,,8409.02
30/04/2019,BGC,SWANSEA UNI - PAY,,3265.85,8410.2
29/04/2019,DEB,WWW.III.CO.UK DE,3000,,5144.35
29/04/2019,DEB,HATHWAY HOUSE ACCO,55,,8144.35
29/04/2019,DEB,PAYPAL *DISC HEALT,39.95,,8199.35
29/04/2019,DEB,Brontosaurus Vegan,18.57,,8239.3
29/04/2019,DEB,POST OFFICE COUNTE,17.8,,8257.87
29/04/2019,DEB,THE BODY SHOP INTL,15,,8275.67
29/04/2019,DEB,MARKS&SPENCER PLC,8.5,,8290.67
29/04/2019,BP,SAVE THE CHANGE,0.66,,8299.17
29/04/2019,TFR,R LAWRENCE  28APR19,,1000,8299.83
26/04/2019,DEB,AMZNMktplace,2.34,,7299.83
26/04/2019,CPT,LNK TESCO FABIAN W,60,,7302.17
25/04/2019,CPT,LNK TESCO FABIAN W,100,,7362.17
25/04/2019,BP,SAVE THE CHANGE,0.01,,7462.17
24/04/2019,DEB,Audible.co.uk,7.99,,7462.18
24/04/2019,BP,SAVE THE CHANGE,1.06,,7470.17
23/04/2019,DEB,WM MORRISONS STORE,44.91,,7471.23
23/04/2019,DEB,Brontosaurus Vegan,23.62,,7516.14
23/04/2019,DEB,AMAZON.CO.UK*MZ3T6,11.81,,7539.76
23/04/2019,DEB,MARKS&SPENCER PLC,8.8,,7551.57
23/04/2019,DEB,COFFEE#1 SWANSEA,3.8,,7560.37
23/04/2019,CPT,LNK TESCO FABIAN W,60,,7564.17
23/04/2019,DD,VIRGIN MEDIA PYMTS,29,,7624.17
23/04/2019,DD,CORGI HOMEPLAN,14.75,,7653.17
18/04/2019,CPT,LNK TESCO FABIAN W,50,,7667.92
18/04/2019,BP,SAVE THE CHANGE,0.47,,7717.92
17/04/2019,DEB,AMZNMktplace,7.93,,7718.39
17/04/2019,DEB,AMZNMKTPLACE AMAZO,3.6,,7726.32
16/04/2019,CPT,LNK FABIAN WAY,150,,7729.92
16/04/2019,DD,O2,18.94,,7879.92
16/04/2019,BP,SAVE THE CHANGE,1.62,,7898.86
15/04/2019,DEB,SAINSBURY'S S/MKT,20.06,,7900.48
15/04/2019,DEB,Brontosaurus Vegan,14.72,,7920.54
15/04/2019,DEB,MARKS&SPENCER PLC,6.7,,7935.26
15/04/2019,DEB,KLM UK  074341,304.9,,7941.96
15/04/2019,CPT,LNK TESCO FABIAN W,250,,8246.86
15/04/2019,CPT,LOYD LOYD 802 OXFO,40,,8496.86
12/04/2019,BP,SAVE THE CHANGE,0.12,,8536.86
11/04/2019,DEB,AMZNMktplace,14.88,,8536.98
11/04/2019,BP,SAVE THE CHANGE,0.36,,8551.86
10/04/2019,DEB,EASYJET   000EWX,85.64,,8552.22
10/04/2019,DEB,EXPEDIA 7425718119,3,,8637.86
10/04/2019,CPT,LNK TESCO FABIAN W,40,,8640.86
09/04/2019,CPT,LNK TESCO FABIAN W,40,,8680.86
09/04/2019,BP,SAVE THE CHANGE,2.13,,8720.86
08/04/2019,DEB,THE GYM LTD,29.99,,8722.99
08/04/2019,DEB,AMZNMktplace,15.66,,8752.98
08/04/2019,DEB,Brontosaurus Vegan,19.02,,8768.64
08/04/2019,DEB,MARKS&SPENCER PLC,7.2,,8787.66
08/04/2019,DD,LV LIFE,37.12,,8794.86
08/04/2019,BP,SAVE THE CHANGE,0.01,,8831.98
05/04/2019,CPT,LNK M&S SWANSEA,50,,8831.99
05/04/2019,DEB,THE GYM LTD,7.99,,8881.99
05/04/2019,BP,SAVE THE CHANGE,0.19,,8889.98
04/04/2019,DEB,WWW.III.CO.UK DE,5000,,8890.17
04/04/2019,DEB,AMZNMktplace,5.81,,13890.17
04/04/2019,BP,SAVE THE CHANGE,1.23,,13895.98
03/04/2019,DEB,AMZNMktplace,24.28,,13897.21
03/04/2019,DEB,Amazon.co.uk*MZ275,10.49,,13921.49
03/04/2019,CPT,LNK TESCO FABIAN W,40,,13931.98
03/04/2019,DD,ASSURANT INTER LTD,21.15,,13971.98
02/04/2019,DEP,CLUB LLOYDS WAIVED,,3,13993.13
02/04/2019,PAY,CLUB LLOYDS FEE,3,,13990.13
02/04/2019,DD,ZURICH,20.69,,13993.13
02/04/2019,BP,SAVE THE CHANGE,2.47,,14013.82
01/04/2019,,INTEREST (GROSS),,6.33,14016.29
01/04/2019,DEB,Brontosaurus Vegan,16.62,,14009.96
01/04/2019,DEB,POST OFFICE COUNTE,12.76,,14026.58
01/04/2019,DEB,MARKS&SPENCER PLC,7.1,,14039.34
01/04/2019,DEB,PAYPAL *JAKUBSTADT,81.05,,14046.44
01/04/2019,DD,PRINCIPALITY BS,957.26,,14127.49
01/04/2019,DD,CC SWANSEA C.TAX,145.69,,15084.75
01/04/2019,DD,GOOD ENERGY LTD,97,,15230.44
01/04/2019,DD,DWR CYMRU W WATER,32.5,,15327.44
01/04/2019,SO,ESAVINGS ACCOUNT,300,,15359.94
01/04/2019,CPT,LNK 1 UNION STREET,40,,15659.94
29/03/2019,CPT,LNK TESCO FABIAN W,40,,15699.94
29/03/2019,DD,UCU B ACCOUNT,24.26,,15739.94
29/03/2019,BP,SAVE THE CHANGE,0.5,,15764.2
29/03/2019,BGC,SWANSEA UNI - PAY,,3251.36,15764.7
28/03/2019,DEB,AMZN MKTP UK*MZ4YK,2.5,,12513.34
27/03/2019,BP,SAVE THE CHANGE,0.7,,12515.84
26/03/2019,DEB,SAINSBURY'S S/MKT,29.3,,12516.54
26/03/2019,BP,SAVE THE CHANGE,1.41,,12545.84
25/03/2019,DEB,ZINCO LOUNGE,14.75,,12547.25
25/03/2019,DEB,Brontosaurus Vegan,15.05,,12562
25/03/2019,DEB,MARKS&SPENCER PLC,10.8,,12577.05
25/03/2019,DEB,Audible.co.uk,7.99,,12587.85
25/03/2019,CPT,LNK TESCO FABIAN W,50,,12595.84
25/03/2019,BP,SAVE THE CHANGE,0.69,,12645.84
22/03/2019,CPT,LNK TESCO FABIAN W,30,,12646.53
22/03/2019,DD,CORGI HOMEPLAN,14.75,,12676.53
22/03/2019,DEB,NON-GBP PURCH FEE,0.5,,12691.28
22/03/2019,DEB,NON-GBP TRANS FEE,6.64,,12691.78
22/03/2019,DEB,B.COM 2160701-KEGH,222.31,,12698.42
22/03/2019,BP,SAVE THE CHANGE,0.56,,12920.73
21/03/2019,DEB,AMZN Mktp UK*MW55R,17.7,,12921.29
21/03/2019,DEB,KLM UK  074341,443.74,,12938.99
21/03/2019,DD,VIRGIN MEDIA PYMTS,29,,13382.73
21/03/2019,BP,SAVE THE CHANGE,0.97,,13411.73
20/03/2019,DEB,AMZN Mktp UK*MW0N1,9.03,,13412.7
20/03/2019,DEB,EXPEDIA 7420654555,3,,13421.73
20/03/2019,BP,SAVE THE CHANGE,0.86,,13424.73
19/03/2019,DEB,AMZN Mktp UK*MW1XF,6.14,,13425.59
19/03/2019,CPT,LNK FABIAN WAY,50,,13431.73
19/03/2019,BP,SAVE THE CHANGE,0.3,,13481.73
18/03/2019,DEB,THE BIKE HUB,20,,13482.03
18/03/2019,DEB,MARKS&SPENCER PLC,4.7,,13502.03
18/03/2019,DD,O2,17.95,,13506.73
18/03/2019,CPT,LNK M&S SWANSEA,40,,13524.68
15/03/2019,CPT,LNK TESCO FABIAN W,40,,13564.68
15/03/2019,BGC,SWANSEA UNIVERSITY,,264.95,13604.68
14/03/2019,BP,SAVE THE CHANGE,0.5,,13339.73
13/03/2019,DEB,AMZN MKTP UK*MW1F6,15.9,,13340.23
13/03/2019,DEB,TESCO STORES 4628,6.6,,13356.13
12/03/2019,CPT,LNK TESCO FABIAN W,40,,13362.73
12/03/2019,BP,SAVE THE CHANGE,0.67,,13402.73
11/03/2019,DEB,Brontosaurus Vegan,33.72,,13403.4
11/03/2019,DEB,MARKS&SPENCER PLC,5,,13437.12
11/03/2019,DEB,Amazon Prime*MW23K,79,,13442.12
11/03/2019,DEB,AMZN Mktp UK*MW6U6,7.61,,13521.12
08/03/2019,CPT,LNK FABIAN WAY,50,,13528.73
08/03/2019,DD,LV LIFE,37.12,,13578.73
08/03/2019,BP,SAVE THE CHANGE,0.99,,13615.85
07/03/2019,DEB,AMAZON.CO.UK*MW8G9,13.01,,13616.84
07/03/2019,CPT,LNK TESCO FABIAN W,40,,13629.85
07/03/2019,BP,SAVE THE CHANGE,0.51,,13669.85
06/03/2019,DEB,AMZN MKTP UK*MW4GI,23.49,,13670.36
06/03/2019,CPT,LNK FABIAN WAY,50,,13693.85
06/03/2019,BP,SAVE THE CHANGE,0.27,,13743.85
05/03/2019,DEB,AMZN Mktp UK*MW6J9,35.73,,13744.12
05/03/2019,BP,SAVE THE CHANGE,2.2,,13779.85
04/03/2019,DEP,CLUB LLOYDS WAIVED,,3,13782.05
04/03/2019,PAY,CLUB LLOYDS FEE,3,,13779.05
04/03/2019,DEB,Amazon.co.uk*MW4OW,16.15,,13782.05
04/03/2019,DEB,MARKS&SPENCER PLC,9.2,,13798.2
04/03/2019,DEB,COFFEE#1 SWANSEA,8.8,,13807.4
04/03/2019,DEB,AMZN Mktp UK*MW8PN,11.65,,13816.2
01/03/2019,,INTEREST (GROSS),,5.71,13827.85
01/03/2019,CPT,LNK TESCO FABIAN W,50,,13822.14
01/03/2019,DD,PRINCIPALITY BS,957.26,,13872.14
01/03/2019,DD,GOOD ENERGY LTD,97,,14829.4
01/03/2019,DD,AVIVA LIFE,46.46,,14926.4
01/03/2019,DD,DWR CYMRU W WATER,23.5,,14972.86
01/03/2019,DD,ASSURANT INTER LTD,21.15,,14996.36
01/03/2019,DD,ZURICH,20.69,,15017.51
01/03/2019,DD,CC SWANSEA C.TAX,13,,15038.2
01/03/2019,SO,ESAVINGS ACCOUNT,300,,15051.2
01/03/2019,BGC,SWANSEA UNIVERSITY,,123.2,15351.2
28/02/2019,DD,UCU B ACCOUNT,24.26,,15228
28/02/2019,BGC,SWANSEA UNI - PAY,,3250.96,15252.26
28/02/2019,BGC,MIDDLESEX UNIV,,404.95,12001.3
27/02/2019,CPT,LNK TESCO FABIAN W,20,,11596.35
26/02/2019,BP,SAVE THE CHANGE,1.79,,11616.35
25/02/2019,DEB,NON-GBP PURCH FEE,0.5,,11618.14
25/02/2019,DEB,NON-GBP TRANS FEE,11.52,,11618.64
25/02/2019,DEB,VEGAN LAUNCH,385.59,,11630.16
25/02/2019,DEB,Amazon.co.uk*MI64R,12.37,,12015.75
25/02/2019,DEB,AMZN MKTP UK*MI4CC,8.99,,12028.12
25/02/2019,DEB,AMZN Mktp UK*MI93A,5.99,,12037.11
25/02/2019,DEB,SHARE DEALINGS LEE,5000,,12043.1
25/02/2019,DEB,Brontosaurus Vegan,20.99,,17043.1
25/02/2019,DEB,POUNDSTRETCHER 270,4.29,,17064.09
25/02/2019,DEB,Audible.co.uk,7.99,,17068.38
25/02/2019,DEB,SHARE DEALINGS LEE,25,,17076.37
25/02/2019,CPT,LNK TESCO FABIAN W,40,,17101.37
22/02/2019,DEB,SAINSBURY'S S/MKT,11,,17141.37
22/02/2019,CPT,LNK TESCO FABIAN W,40,,17152.37
22/02/2019,DD,CORGI HOMEPLAN,14.75,,17192.37
21/02/2019,DD,VIRGIN MEDIA PYMTS,29,,17207.12
19/02/2019,CPT,LNK FABIAN WAY,50,,17236.12
19/02/2019,BP,SAVE THE CHANGE,0.66,,17286.12
18/02/2019,DEB,ZARA SWANSEA,49.99,,17286.78
18/02/2019,DEB,Brontosaurus Vegan,12.66,,17336.77
18/02/2019,DEB,AMZN Mktp UK*MI3BZ,11.99,,17349.43
18/02/2019,DEB,MARKS&SPENCER PLC,8.7,,17361.42
18/02/2019,DD,O2,17.95,,17370.12
18/02/2019,BP,SAVE THE CHANGE,0.57,,17388.07
15/02/2019,DEB,AMZN Mktp UK*MI5TU,8.43,,17388.64
15/02/2019,CPT,LNK TESCO FABIAN W,50,,17397.07
13/02/2019,BP,SAVE THE CHANGE,0.64,,17447.07
12/02/2019,DEB,AMZN MKTP UK*MI4ED,8.37,,17447.71
12/02/2019,DEB,AMZN Mktp UK*MI5RP,7.99,,17456.08
12/02/2019,CPT,LNK UNI - UNIVERSI,50,,17464.07
12/02/2019,BP,SAVE THE CHANGE,1.45,,17514.07
11/02/2019,DEB,AMAZON.CO.UK*MI5QA,7.86,,17515.52
11/02/2019,DEB,Brontosaurus Vegan,23.62,,17523.38
11/02/2019,DEB,IQRA SWANSEA LIMIT,20.97,,17547
11/02/2019,DEB,MARKS&SPENCER PLC,8.1,,17567.97
11/02/2019,DEB,POUNDLAND LTD 1414,4,,17576.07
08/02/2019,DD,LV LIFE,37.12,,17580.07
08/02/2019,BP,SAVE THE CHANGE,0.87,,17617.19
07/02/2019,DEB,POUNDSTRETCHER 270,7.13,,17618.06
07/02/2019,CPT,LNK TESCO FABIAN W,60,,17625.19
07/02/2019,BP,SAVE THE CHANGE,0.85,,17685.19
06/02/2019,DEB,SAINSBURY'S S/MKT,22.15,,17686.04
06/02/2019,BP,SAVE THE CHANGE,0.61,,17708.19
05/02/2019,DEB,AMZN Mktp UK*MI47S,2.39,,17708.8
05/02/2019,CPT,LNK FABIAN WAY,50,,17711.19
05/02/2019,BP,SAVE THE CHANGE,0.67,,17761.19
04/02/2019,DEP,CLUB LLOYDS WAIVED,,3,17761.86
04/02/2019,PAY,CLUB LLOYDS FEE,3,,17758.86
04/02/2019,DEB,Brontosaurus Vegan,26.73,,17761.86
04/02/2019,DEB,MARKS&SPENCER PLC,13.6,,17788.59
04/02/2019,DD,ASSURANT INTER LTD,21.15,,17802.19
04/02/2019,BP,SAVE THE CHANGE,0.33,,17823.34
01/02/2019,,INTEREST (GROSS),,6.12,17823.67
01/02/2019,DEB,TESCO STORES 4628,2.67,,17817.55
01/02/2019,DD,PRINCIPALITY BS,957.26,,17820.22
01/02/2019,DD,GOOD ENERGY LTD,97,,18777.48
01/02/2019,DD,AVIVA LIFE,46.46,,18874.48
01/02/2019,DD,DWR CYMRU W WATER,23.5,,18920.94
01/02/2019,DD,ZURICH,20.69,,18944.44
01/02/2019,DD,CC SWANSEA C.TAX,13.81,,18965.13
01/02/2019,SO,ESAVINGS ACCOUNT,300,,18978.94
01/02/2019,BP,SAVE THE CHANGE,0.8,,19278.94
31/01/2019,DEB,BIRMINGHAM INT HOT,47,,19279.74
31/01/2019,DEB,WASABI BIRMINGHAM,12.2,,19326.74
31/01/2019,CPT,LNK TESCO FABIAN W,60,,19338.94
31/01/2019,DD,UCU B ACCOUNT,24.26,,19398.94
31/01/2019,BP,SAVE THE CHANGE,1,,19423.2
31/01/2019,BGC,SWANSEA UNI - PAY,,3251.36,19424.2
30/01/2019,DEB,TFW RAIL SERVICES,67.4,,16172.84
30/01/2019,DEB,SHREWSBURY STARBUC,8.6,,16240.24
30/01/2019,DEB,THE BIKE HUB,5,,16248.84
29/01/2019,CPT,LOYD LOYD 802 OXFO,60,,16253.84
29/01/2019,BP,SAVE THE CHANGE,0.8,,16313.84
28/01/2019,DEB,MARKS&SPENCER PLC,10.2,,16314.64
28/01/2019,BP,SAVE THE CHANGE,0.1,,16324.84
25/01/2019,DEB,SAINSBURY'S S/MKT,12.9,,16324.94
25/01/2019,CPT,LNK TESCO FABIAN W,60,,16337.84
25/01/2019,BP,SAVE THE CHANGE,0.01,,16397.84
24/01/2019,DEB,Audible.co.uk,7.99,,16397.85
24/01/2019,BP,SAVE THE CHANGE,0.5,,16405.84
23/01/2019,DEB,HOLIDAY INNS,96,,16406.34
23/01/2019,DEB,HOLIDAY INNS,3.5,,16502.34
23/01/2019,BP,SAVE THE CHANGE,0.9,,16505.84
22/01/2019,DEB,LUL TICKET MACHINE,13.1,,16506.74
22/01/2019,DD,CORGI HOMEPLAN,14.75,,16519.84
22/01/2019,BP,SAVE THE CHANGE,2.36,,16534.59
21/01/2019,DEB,PIZZA EXPRESS,27.45,,16536.95
21/01/2019,DEB,Brontosaurus Vegan,20.89,,16564.4
21/01/2019,DEB,MARKS&SPENCER PLC,13.2,,16585.29
21/01/2019,DEB,COFFEE#1 SWANSEA,6.6,,16598.49
21/01/2019,DEB,TESCO STORES 4628,6.5,,16605.09
21/01/2019,DD,VIRGIN MEDIA PYMTS,29,,16611.59
21/01/2019,CPT,LNK BEST ONE,40,,16640.59
18/01/2019,CPT,LNK TESCO FABIAN W,60,,16680.59
18/01/2019,BP,SAVE THE CHANGE,0.3,,16740.59
17/01/2019,DEB,GWR WEBSALES,116.7,,16740.89
16/01/2019,DD,O2,16.78,,16857.59
16/01/2019,BP,SAVE THE CHANGE,0.33,,16874.37
15/01/2019,CPT,LNK TESCO FABIAN W,60,,16874.7
15/01/2019,DEB,SAINSBURYS S/MKTS,30,,16934.7
15/01/2019,DEB,NON-GBP PURCH FEE,0.5,,16964.7
15/01/2019,DEB,NON-GBP TRANS FEE,0.58,,16965.2
15/01/2019,DEB,RMV CONTACT CENTER,19.67,,16965.78
15/01/2019,BP,SAVE THE CHANGE,0.39,,16985.45
14/01/2019,DEB,Brontosaurus Vegan,23.61,,16985.84
14/01/2019,BP,REMUS MANAGEMENTV2,126.69,,17009.45
11/01/2019,CPT,LNK TESCO FABIAN W,60,,17136.14
11/01/2019,DD,LV LIFE,37.12,,17196.14
08/01/2019,BP,SAVE THE CHANGE,0.79,,17233.26
07/01/2019,DEB,Brontosaurus Vegan,21.41,,17234.05
07/01/2019,DEB,NON-GBP PURCH FEE,0.5,,17255.46
07/01/2019,DEB,NON-GBP TRANS FEE,4.18,,17255.96
07/01/2019,DEB,ART VILLA NAUTILUS,140,,17260.14
07/01/2019,DEB,GWR BRISTOL TM SST,28.8,,17400.14
07/01/2019,CPT,LOYD LOYD 802 OXFO,60,,17428.94
03/01/2019,DEP,CLUB LLOYDS WAIVED,,3,17488.94
03/01/2019,PAY,CLUB LLOYDS FEE,3,,17485.94
03/01/2019,DD,ASSURANT INTER LTD,21.15,,17488.94
03/01/2019,DD,ZURICH,20.69,,17510.09
02/01/2019,,INTEREST (GROSS),,6.12,17530.78
02/01/2019,DD,PRINCIPALITY BS,957.26,,17524.66
02/01/2019,DD,GOOD ENERGY LTD,97,,18481.92
02/01/2019,DD,AVIVA LIFE,46.46,,18578.92
02/01/2019,DD,DWR CYMRU W WATER,23.5,,18625.38
02/01/2019,SO,ESAVINGS ACCOUNT,300,,18648.88
31/12/2018,DD,UCU B ACCOUNT,24.26,,18948.88
31/12/2018,BP,SAVE THE CHANGE,0.6,,18973.14
31/12/2018,BGC,SWANSEA UNI - PAY,,3251.36,18973.74
28/12/2018,DEB,TFW RAIL SERVICES,8.4,,15722.38
28/12/2018,BP,SAVE THE CHANGE,1.79,,15730.78
27/12/2018,DEB,NON-GBP PURCH FEE,0.5,,15732.57
27/12/2018,DEB,NON-GBP TRANS FEE,1.34,,15733.07
27/12/2018,DEB,Hotel on Booking.c,45.14,,15734.41
27/12/2018,DEB,FRANCESCO LEONE,147.73,,15779.55
27/12/2018,DEB,NON-GBP PURCH FEE,0.5,,15927.28
27/12/2018,DEB,NON-GBP TRANS FEE,0.39,,15927.78
27/12/2018,DEB,COVIRAN LOS ABRIGO,13.34,,15928.17
27/12/2018,BP,SAVE THE CHANGE,1.77,,15941.51
24/12/2018,DEB,AMZN Mktp UK*M2882,2.71,,15943.28
24/12/2018,DEB,Audible.co.uk,7.99,,15945.99
24/12/2018,DEB,Brontosaurus Vegan,12.98,,15953.98
24/12/2018,DEB,POST OFFICE SELF S,24.35,,15966.96
24/12/2018,DEB,SAINSBURY'S S/MKT,20.5,,15991.31
24/12/2018,DEB,MARKS&SPENCER PLC,2.7,,16011.81
24/12/2018,DD,CORGI HOMEPLAN,14.75,,16014.51
24/12/2018,BGC,SWANSEA UNIVERSITY,,516.6,16029.26
24/12/2018,CPT,LNK M&S SWANSEA,40,,15512.66
21/12/2018,CPT,P.O. 37 THE QUADAN,99.01,,15552.66
21/12/2018,DD,VIRGIN MEDIA PYMTS,29,,15651.67
20/12/2018,BP,SAVE THE CHANGE,0.2,,15680.67
19/12/2018,DEB,SAINSBURY'S S/MKT,24.8,,15680.87
19/12/2018,CPT,LNK TESCO FABIAN W,60,,15705.67
19/12/2018,BP,SAVE THE CHANGE,0.09,,15765.67
18/12/2018,DEB,Amazon.co.uk*M23Q2,5.91,,15765.76
18/12/2018,BP,SAVE THE CHANGE,1.26,,15771.67
17/12/2018,DEB,TUI,259,,15772.93
17/12/2018,DEB,TUI,84,,16031.93
17/12/2018,DEB,DEBENHAMS,72,,16115.93
17/12/2018,DEB,HOSTEL WORLD,22.24,,16187.93
17/12/2018,DEB,TFW RAIL SERVICES,11.5,,16210.17
17/12/2018,DD,O2,18.5,,16221.67
17/12/2018,CPT,LNK ARRIVA TRAINS,50,,16240.17
14/12/2018,DEB,TESCO STORES 4628,11,,16290.17
14/12/2018,BGC,SWANSEA UNIVERSITY,,939.47,16301.17
13/12/2018,DEB,EUROPEAN MOVING,230,,15361.7
13/12/2018,CPT,LNK TESCO FABIAN W,60,,15591.7
11/12/2018,BP,SAVE THE CHANGE,0.51,,15651.7
10/12/2018,CPT,LNK TESCO FABIAN W,40,,15652.21
10/12/2018,DEB,MOUNTAIN WAREHOUSE,49.99,,15692.21
10/12/2018,DEB,TFW RAIL SERVICES,11.5,,15742.2
10/12/2018,DD,LV LIFE,37.12,,15753.7
10/12/2018,CPT,LNK CARDIFF 1,40,,15790.82
06/12/2018,CPT,LNK TESCO FABIAN W,60,,15830.82
06/12/2018,BP,SAVE THE CHANGE,1.11,,15890.82
05/12/2018,DEB,EUROPEAN MOVING,511.7,,15891.93
05/12/2018,DEB,AMAZON.CO.UK*M005N,4.19,,16403.63
05/12/2018,BP,SAVE THE CHANGE,0.04,,16407.82
04/12/2018,DEP,CLUB LLOYDS WAIVED,,3,16407.86
04/12/2018,PAY,CLUB LLOYDS FEE,3,,16404.86
04/12/2018,DEB,AMZN MKTP UK*M04GF,3.96,,16407.86
04/12/2018,CPT,LNK TESCO FABIAN W,40,,16411.82
04/12/2018,BP,SAVE THE CHANGE,0.9,,16451.82
03/12/2018,,INTEREST (GROSS),,6.53,16452.72
03/12/2018,DEB,AMAZON.CO.UK*M050B,22.6,,16446.19
03/12/2018,DEB,SAINSBURYS S/MKTS,22.5,,16468.79
03/12/2018,DD,PRINCIPALITY BS,957.26,,16491.29
03/12/2018,DD,CC SWANSEA C.TAX,184,,17448.55
03/12/2018,DD,GOOD ENERGY LTD,97,,17632.55
03/12/2018,DD,AVIVA LIFE,46.46,,17729.55
03/12/2018,DD,DWR CYMRU W WATER,23.5,,17776.01
03/12/2018,DD,ASSURANT INTER LTD,21.15,,17799.51
03/12/2018,DD,ZURICH,20.69,,17820.66
03/12/2018,SO,ESAVINGS ACCOUNT,300,,17841.35
03/12/2018,BP,SAVE THE CHANGE,0.55,,18141.35
03/12/2018,CPT,LOYD LOYD 802 OXFO,50,,18141.9
30/11/2018,DEB,LAS IGUNAS,36.45,,18191.9
30/11/2018,DD,UCU B ACCOUNT,24.26,,18228.35
30/11/2018,BGC,SWANSEA UNI - PAY,,3251.36,18252.61
29/11/2018,CPT,LNK PO THE CITYOFS,50,,15001.25
27/11/2018,BP,SAVE THE CHANGE,1.35,,15051.25
26/11/2018,DEB,EASYJET   EVXNX8,32,,15052.6
26/11/2018,DEB,WILKO RETAIL LIMIT,23,,15084.6
26/11/2018,DEB,AMAZON.CO.UK*M83AN,11.85,,15107.6
26/11/2018,DEB,AMZN MKTP UK*M849V,49.98,,15119.45
26/11/2018,DEB,Brontosaurus Vegan,33.6,,15169.43
26/11/2018,DEB,AMAZON.CO.UK*M83UY,3.23,,15203.03
26/11/2018,DEB,Audible.co.uk,7.99,,15206.26
26/11/2018,CPT,LNK UNI - UNIVERSI,80,,15214.25
23/11/2018,CPT,LNK TESCO FABIAN W,40,,15294.25
22/11/2018,DD,CORGI HOMEPLAN,14.75,,15334.25
22/11/2018,BP,SAVE THE CHANGE,1.06,,15349
21/11/2018,DEB,AMZN Mktp UK*M85HN,8.88,,15350.06
21/11/2018,DEB,Amazon.co.uk*M88N5,4.33,,15358.94
21/11/2018,CPT,LNK TESCO FABIAN W,40,,15363.27
21/11/2018,DD,VIRGIN MEDIA PYMTS,29,,15403.27
21/11/2018,DEB,NON-GBP PURCH FEE,0.5,,15432.27
21/11/2018,DEB,NON-GBP TRANS FEE,1.06,,15432.77
21/11/2018,DEB,KLM*REF UGUA8R OPT,35.73,,15433.83
21/11/2018,BP,SAVE THE CHANGE,0.35,,15469.56
20/11/2018,DEB,NON-GBP PURCH FEE,0.5,,15469.91
20/11/2018,DEB,NON-GBP TRANS FEE,6.75,,15470.41
20/11/2018,DEB,SCHLOSS DAGSTUHL -,225.81,,15477.16
20/11/2018,DEB,NON-GBP PURCH FEE,0.5,,15702.97
20/11/2018,DEB,NON-GBP TRANS FEE,2.47,,15703.47
20/11/2018,DEB,SCHLOSS DAGSTUHL -,82.84,,15705.94
20/11/2018,BP,SAVE THE CHANGE,0.6,,15788.78
19/11/2018,DEB,Brontosaurus Vegan,24.41,,15789.38
19/11/2018,DEB,CANDLES & CO,21.99,,15813.79
19/11/2018,CPT,LNK M&S SWANSEA,80,,15835.78
16/11/2018,DD,O2,19.45,,15915.78
15/11/2018,BP,SAVE THE CHANGE,0.03,,15935.23
14/11/2018,DEB,NON-GBP PURCH FEE,0.5,,15935.26
14/11/2018,DEB,NON-GBP TRANS FEE,1.76,,15935.76
14/11/2018,DEB,DB AUTOMATEN,58.97,,15937.52
14/11/2018,BP,SAVE THE CHANGE,0.17,,15996.49
13/11/2018,DEB,KLM UNITEDKI074822,34.83,,15996.66
13/11/2018,BP,SAVE THE CHANGE,0.8,,16031.49
12/11/2018,DEB,ARRIVA TRAINS WALE,38.2,,16032.29
12/11/2018,CPT,LNK ARRIVA TRAINS,40,,16070.49
12/11/2018,CPT,LNK M&S SWANSEA,60,,16110.49
09/11/2018,DD,LV LIFE,37.12,,16170.49
07/11/2018,CPT,LNK TESCO FABIAN W,60,,16207.61
05/11/2018,DD,ASSURANT INTER LTD,21.15,,16267.61
02/11/2018,DEP,CLUB LLOYDS WAIVED,,3,16288.76
02/11/2018,PAY,CLUB LLOYDS FEE,3,,16285.76
02/11/2018,BGC,SWANSEA UNIVERSITY,,105.6,16288.76
01/11/2018,,INTEREST (GROSS),,6.33,16183.16
01/11/2018,DD,PRINCIPALITY BS,957.26,,16176.83
01/11/2018,DD,CC SWANSEA C.TAX,184,,17134.09
01/11/2018,DD,GOOD ENERGY LTD,97,,17318.09
01/11/2018,DD,AVIVA LIFE,46.46,,17415.09
01/11/2018,DD,DWR CYMRU W WATER,23.5,,17461.55
01/11/2018,DD,ZURICH,20.69,,17485.05
01/11/2018,SO,ESAVINGS ACCOUNT,300,,17505.74
31/10/2018,DD,UCU B ACCOUNT,24.26,,17805.74
31/10/2018,BP,SAVE THE CHANGE,0.87,,17830
31/10/2018,BGC,SWANSEA UNI - PAY,,3251.36,17830.87
30/10/2018,DEB,SWANSEA UNI - CATE,4.5,,14579.51
30/10/2018,CHQ,LOYD 802 OXFORD ST,,1383,14584.01
30/10/2018,DEB,NON-GBP PURCH FEE,0.5,,13201.01
30/10/2018,DEB,NON-GBP TRANS FEE,22.14,,13201.51
30/10/2018,DEB,ESTREL FRONT OFFIC,740.63,,13223.65
30/10/2018,BP,SAVE THE CHANGE,1.16,,13964.28
29/10/2018,DEB,Brontosaurus Vegan,31.34,,13965.44
29/10/2018,DEB,ARRIVA TRAINS WALE,11.5,,13996.78
29/10/2018,CPT,LNK TESCO FABIAN W,40,,14008.28
29/10/2018,CPT,LOYD LOYD 802 OXFO,50,,14048.28
25/10/2018,BP,SAVE THE CHANGE,0.01,,14098.28
24/10/2018,DEB,Audible.co.uk,7.99,,14098.29
22/10/2018,DD,VIRGIN MEDIA PYMTS,22.4,,14106.28
22/10/2018,DD,CORGI HOMEPLAN,14.75,,14128.68
22/10/2018,BP,SAVE THE CHANGE,1.29,,14143.43
19/10/2018,DEB,TESCO STORES 4628,12.25,,14144.72
19/10/2018,DEB,AMZN Mktp UK,3.46,,14156.97
19/10/2018,BP,SAVE THE CHANGE,0.35,,14160.43
18/10/2018,DEB,AMZN Mktp UK,69.99,,14160.78
18/10/2018,DEB,AMAZON.CO.UK AMAZO,11.77,,14230.77
18/10/2018,DEB,Amazon.co.uk,6.89,,14242.54
18/10/2018,CPT,LNK TESCO FABIAN W,50,,14249.43
18/10/2018,BP,SAVE THE CHANGE,0.77,,14299.43
17/10/2018,DEB,NON-STG PURCH FEE,0.5,,14300.2
17/10/2018,DEB,NON-STG TRANS FEE,1.14,,14300.7
17/10/2018,DEB,WPY*PayIt2com Ragh,38.23,,14301.84
16/10/2018,CPT,LNK TESCO FABIAN W,50,,14340.07
16/10/2018,DD,O2,18.5,,14390.07
16/10/2018,BP,SAVE THE CHANGE,0.01,,14408.57
15/10/2018,DEB,AMZN Mktp UK,14.99,,14408.58
11/10/2018,BP,SAVE THE CHANGE,0.52,,14423.57
10/10/2018,DEB,EASYJET   EVXNX8,359.9,,14424.09
10/10/2018,DEB,AMZN MKTP UK AMAZO,7.99,,14783.99
10/10/2018,DEB,AMZN MKTP UK AMAZO,7.59,,14791.98
10/10/2018,TFR,F/FLOW KATHLEEN M,,721.25,14799.57
09/10/2018,FPI,MARIANA MILLS,,180,14078.32
09/10/2018,BP,SAVE THE CHANGE,0.49,,13898.32
08/10/2018,DEB,AMZN Mktp UK,5.51,,13898.81
08/10/2018,CPT,LNK UNI - UNIVERSI,100,,13904.32
08/10/2018,DD,LV LIFE,37.12,,14004.32
08/10/2018,CPT,LNK M&S SWANSEA,100,,14041.44
05/10/2018,CPT,LNK UNI - UNIVERSI,50,,14141.44
05/10/2018,BP,SAVE THE CHANGE,0.35,,14191.44
04/10/2018,DEB,DELIVEROO.CO.UK,24.65,,14191.79
03/10/2018,DD,ASSURANT INTER LTD,21.15,,14216.44
03/10/2018,BP,SAVE THE CHANGE,0.01,,14237.59
02/10/2018,DEP,CLUB LLOYDS WAIVED,,3,14237.6
02/10/2018,PAY,CLUB LLOYDS FEE,3,,14234.6
02/10/2018,DEB,Amazon.co.uk,14.99,,14237.6
02/10/2018,BP,SAVE THE CHANGE,3.25,,14252.59
01/10/2018,,INTEREST (GROSS),,5.71,14255.84
01/10/2018,DEB,AMZN Mktp UK,23.88,,14250.13
01/10/2018,DEB,AMZN Mktp UK,4.49,,14274.01
01/10/2018,DEB,Brontosaurus Vegan,37.29,,14278.5
01/10/2018,DEB,GOOGLE *YouTube Vi,3.49,,14315.79
01/10/2018,DEB,ARRIVA TRAINS WALE,75.1,,14319.28
01/10/2018,DEB,WASABI BIRMINGHAM,30.5,,14394.38
01/10/2018,DEB,easyHotel Birmingh,10,,14424.88
01/10/2018,DD,PRINCIPALITY BS,957.26,,14434.88
01/10/2018,DD,CC SWANSEA C.TAX,184,,15392.14
01/10/2018,DD,GOOD ENERGY LTD,97,,15576.14
01/10/2018,DD,AVIVA LIFE,46.46,,15673.14
01/10/2018,DD,DWR CYMRU W WATER,23.5,,15719.6
01/10/2018,DD,ZURICH,20.69,,15743.1
01/10/2018,SO,ESAVINGS ACCOUNT,300,,15763.79
01/10/2018,CPT,LNK MORRISONS SWAN,50,,16063.79
28/09/2018,DD,UCU B ACCOUNT,24.26,,16113.79
28/09/2018,BGC,SWANSEA UNI - PAY,,3250.96,16138.05
26/09/2018,CPT,LNK UNI - UNIVERSI,50,,12887.09
25/09/2018,BP,SAVE THE CHANGE,0.95,,12937.09
24/09/2018,DEB,Audible.co.uk,7.99,,12938.04
24/09/2018,DEB,Brontosaurus Vegan,43.06,,12946.03
24/09/2018,CPT,LNK MORRISONS SWAN,200,,12989.09
21/09/2018,DD,VIRGIN MEDIA PYMTS,40,,13189.09
21/09/2018,BP,SAVE THE CHANGE,0.6,,13229.09
21/09/2018,BGC,SWANSEA UNIVERSITY,,170.74,13229.69
20/09/2018,DEB,DELIVEROO.CO.UK,24.4,,13058.95
20/09/2018,BP,SAVE THE CHANGE,0.01,,13083.35
19/09/2018,DEB,Amazon.co.uk,77,,13083.36
19/09/2018,DEB,easyHotel Birmingh,42.99,,13160.36
19/09/2018,CPT,LNK UNI - UNIVERSI,50,,13203.35
18/09/2018,BP,SAVE THE CHANGE,0.04,,13253.35
17/09/2018,DEB,AMZN MKTP UK AMAZO,33.96,,13253.39
17/09/2018,DD,O2,17.95,,13287.35
17/09/2018,BP,SAVE THE CHANGE,0.37,,13305.3
14/09/2018,DEB,AMZN Mktp UK,2.63,,13305.67
14/09/2018,BP,SAVE THE CHANGE,0.6,,13308.3
13/09/2018,DEB,DELIVEROO.CO.UK,24.4,,13308.9
13/09/2018,BP,SAVE THE CHANGE,0.25,,13333.3
12/09/2018,DEB,AMZN Mktp UK,2.75,,13333.55
11/09/2018,BP,SAVE THE CHANGE,2.36,,13336.3
10/09/2018,DEB,SQ *FLOOR & DECOR,341.05,,13338.66
10/09/2018,DEB,Brontosaurus Vegan,21.51,,13679.71
10/09/2018,DEB,MARKS&SPENCER PLC,11.4,,13701.22
10/09/2018,DEB,AMZN Mktp UK,8.68,,13712.62
10/09/2018,DD,LV LIFE,37.12,,13721.3
07/09/2018,BP,SAVE THE CHANGE,0.51,,13758.42
06/09/2018,DEB,Amazon.co.uk,35.49,,13758.93
05/09/2018,DD,ASSURANT INTER LTD,21.3,,13794.42
05/09/2018,BP,SAVE THE CHANGE,0.75,,13815.72
04/09/2018,DEP,CLUB LLOYDS WAIVED,,3,13816.47
04/09/2018,PAY,CLUB LLOYDS FEE,3,,13813.47
04/09/2018,DEB,AMZN Mktp UK,5.25,,13816.47
04/09/2018,BP,SAVE THE CHANGE,1.02,,13821.72
04/09/2018,BGC,IRG ADVISORS LLP,,345.8,13822.74
04/09/2018,BGC,IRG ADVISORS LLP,,116.4,13476.94
03/09/2018,,INTEREST (GROSS),,6.74,13360.54
03/09/2018,DEB,Brontosaurus Vegan,23.53,,13353.8
03/09/2018,DEB,PAYPAL *VIMEO INC,3.45,,13377.33
03/09/2018,DD,PRINCIPALITY BS,957.26,,13380.78
03/09/2018,DD,CC SWANSEA C.TAX,184,,14338.04
03/09/2018,DD,GOOD ENERGY LTD,97,,14522.04
03/09/2018,DD,AVIVA LIFE,46.46,,14619.04
03/09/2018,DD,DWR CYMRU W WATER,23.5,,14665.5
03/09/2018,DD,ZURICH,19.36,,14689
03/09/2018,SO,ESAVINGS ACCOUNT,300,,14708.36
03/09/2018,BP,SAVE THE CHANGE,0.01,,15008.36
03/09/2018,FPO,P M GREY,1360,,15008.37
31/08/2018,DEB,AMZN Mktp UK,33.99,,16368.37
31/08/2018,CPT,LNK UNI - UNIVERSI,40,,16402.36
31/08/2018,DD,UCU B ACCOUNT,23.11,,16442.36
31/08/2018,BGC,SWANSEA UNI - PAY,,3251.36,16465.47
30/08/2018,CPT,LNK UNI - UNIVERSI,50,,13214.11
30/08/2018,BP,SAVE THE CHANGE,0.9,,13264.11
29/08/2018,DEB,AMZN Mktp UK,7.31,,13265.01
29/08/2018,DEB,AMZN Mktp UK,2.79,,13272.32
29/08/2018,BP,SAVE THE CHANGE,1.1,,13275.11
28/08/2018,DEB,AMZN Mktp UK,8.99,,13276.21
28/08/2018,DEB,ARRIVA TRAINS WALE,11.5,,13285.2
28/08/2018,DEB,Brontosaurus Vegan,24.41,,13296.7
28/08/2018,CPT,LNK UNI - UNIVERSI,40,,13321.11
28/08/2018,BP,SAVE THE CHANGE,0.16,,13361.11
28/08/2018,CPT,LNK ARRIVA TRAINS,40,,13361.27
24/08/2018,DEB,PIZZA EXPRESS,86.85,,13401.27
24/08/2018,DEB,Audible.co.uk,7.99,,13488.12
24/08/2018,CPT,LNK M&S SWANSEA,20,,13496.11
24/08/2018,BGC,SWANSEA UNIVERSITY,,276.32,13516.11
22/08/2018,CPT,LNK UNI - UNIVERSI,50,,13239.79
22/08/2018,BP,SAVE THE CHANGE,0.4,,13289.79
21/08/2018,FPO,P M GREY,3500,,13290.19
21/08/2018,DEB,AMZN Mktp UK,7.98,,16790.19
21/08/2018,DEB,AMZN Mktp UK,2.62,,16798.17
21/08/2018,DD,VIRGIN MEDIA PYMTS,27,,16800.79
21/08/2018,BP,SAVE THE CHANGE,1.55,,16827.79
20/08/2018,DEB,AMZN Mktp UK,10,,16829.34
20/08/2018,DEB,AMZN Mktp UK,7.25,,16839.34
20/08/2018,DEB,Brontosaurus Vegan,28.2,,16846.59
20/08/2018,BP,SAVE THE CHANGE,0.9,,16874.79
20/08/2018,CPT,LNK M&S SWANSEA,50,,16875.69
17/08/2018,DEB,ARRIVA TRAINS WALE,87.1,,16925.69
17/08/2018,DEB,BEAUFORT PARK HOTE,58,,17012.79
17/08/2018,BP,SAVE THE CHANGE,1,,17070.79
16/08/2018,DEB,AMZN Mktp UK,5.45,,17071.79
16/08/2018,DEB,AMZN Mktp UK,3.55,,17077.24
16/08/2018,CPT,LNK UNI - UNIVERSI,60,,17080.79
16/08/2018,DD,O2,19,,17140.79
15/08/2018,BP,SAVE THE CHANGE,0.11,,17159.79
14/08/2018,DEB,AMZN Mktp UK,6.89,,17159.9
14/08/2018,BP,SAVE THE CHANGE,0.6,,17166.79
13/08/2018,DEB,AMZN MKTP UK AMAZO,5.4,,17167.39
08/08/2018,DD,LV LIFE,37.12,,17172.79
06/08/2018,DEB,NON-STG CASH FEE,1.5,,17209.91
06/08/2018,DEB,NON-STG TRANS FEE,2.66,,17211.41
06/08/2018,DEB,ST PAUL'S BAY,89.2,,17214.07
06/08/2018,DD,ASSURANT INTER LTD,21.37,,17303.27
02/08/2018,DEP,CLUB LLOYDS WAIVED,,3,17324.64
02/08/2018,PAY,CLUB LLOYDS FEE,3,,17321.64
01/08/2018,,INTEREST (GROSS),,6.12,17324.64
01/08/2018,DD,PRINCIPALITY BS,957.26,,17318.52
01/08/2018,DD,CC SWANSEA C.TAX,184,,18275.78
01/08/2018,DD,GOOD ENERGY LTD,97,,18459.78
01/08/2018,DD,AVIVA LIFE,46.46,,18556.78
01/08/2018,DD,DWR CYMRU W WATER,23.5,,18603.24
01/08/2018,DD,ZURICH,19.36,,18626.74
01/08/2018,SO,ESAVINGS ACCOUNT,300,,18646.1
31/07/2018,DD,UCU B ACCOUNT,23.11,,18946.1
31/07/2018,BP,SAVE THE CHANGE,2.14,,18969.21
31/07/2018,BGC,SWANSEA UNI - PAY,,3200.58,18971.35
30/07/2018,DEB,NON-STG PURCH FEE,0.5,,15770.77
30/07/2018,DEB,NON-STG TRANS FEE,5.38,,15771.27
30/07/2018,DEB,Hotel on Booking.c,180.25,,15776.65
30/07/2018,DEB,Amazon UK Retail,9.87,,15956.9
30/07/2018,DEB,JS ONLINE GROCERY,100.55,,15966.77
30/07/2018,DEB,Brontosaurus Vegan,36.2,,16067.32
30/07/2018,DEB,Amazon UK Marketpl,15.99,,16103.52
30/07/2018,BP,SAVE THE CHANGE,0.87,,16119.51
30/07/2018,CPT,LNK 37 THE QUADANT,182.13,,16120.38
27/07/2018,DEB,AMAZON SVCS EU-UK,11.13,,16302.51
27/07/2018,CPT,LNK UNI - UNIVERSI,40,,16313.64
27/07/2018,BP,SAVE THE CHANGE,0.06,,16353.64
27/07/2018,BGC,SWANSEA UNIVERSITY,,136.28,16353.7
26/07/2018,DEB,Amazon UK Marketpl,42.94,,16217.42
26/07/2018,BP,SAVE THE CHANGE,0.75,,16260.36
25/07/2018,DEB,Amazon UK Marketpl,4.25,,16261.11
25/07/2018,CPT,LNK UNI - UNIVERSI,60,,16265.36
25/07/2018,BP,SAVE THE CHANGE,0.52,,16325.36
24/07/2018,DEB,Amazon UK Marketpl,4.49,,16325.88
24/07/2018,DEB,Audible.co.uk,7.99,,16330.37
24/07/2018,BP,SAVE THE CHANGE,0.5,,16338.36
23/07/2018,DEB,ROOT,3.5,,16338.86
23/07/2018,DD,VIRGIN MEDIA PYMTS,27,,16342.36
23/07/2018,CPT,LOYD 802 OXFORD ST,50,,16369.36
20/07/2018,CPT,LNK UNI - UNIVERSI,60,,16419.36
17/07/2018,BP,SAVE THE CHANGE,1.55,,16479.36
16/07/2018,DEB,ARRIVA TRAINS WALE,75.1,,16480.91
16/07/2018,DEB,BIRMINGHAM INT HOT,33,,16556.01
16/07/2018,DEB,Amazon UK Marketpl,5.35,,16589.01
16/07/2018,DD,O2,17.95,,16594.36
16/07/2018,CPT,LNK ARRIVA TRAINS,60,,16612.31
13/07/2018,CPT,LNK ARRIVA TRAINS,40,,16672.31
13/07/2018,BGC,SWANSEA UNIVERSITY,,939.33,16712.31
11/07/2018,BP,SAVE THE CHANGE,0.7,,15772.98
10/07/2018,DEB,ARRIVA TRAINS WALE,128.3,,15773.68
10/07/2018,DEB,THE ALBANY HOTEL,75,,15901.98
09/07/2018,CPT,LNK UNI - UNIVERSI,40,,15976.98
09/07/2018,DD,LV LIFE,37.12,,16016.98
09/07/2018,BP,SAVE THE CHANGE,0.91,,16054.1
06/07/2018,DEB,AMAZON EU AMAZON.C,7.09,,16055.01
06/07/2018,BP,SAVE THE CHANGE,1.39,,16062.1
05/07/2018,DEB,WATSON & PRATTS,92.53,,16063.49
05/07/2018,DEB,Amazon UK Retail,19.08,,16156.02
04/07/2018,DEP,CLUB LLOYDS WAIVED,,3,16175.1
04/07/2018,PAY,CLUB LLOYDS FEE,3,,16172.1
04/07/2018,BP,SAVE THE CHANGE,0.52,,16175.1
03/07/2018,DEB,Amazon UK Marketpl,12.48,,16175.62
03/07/2018,DD,ASSURANT INTER LTD,21.37,,16188.1
03/07/2018,DD,ZURICH,19.36,,16209.47
03/07/2018,BP,SAVE THE CHANGE,0.01,,16228.83
02/07/2018,,INTEREST (GROSS),,8.28,16228.84
02/07/2018,DEB,Amazon UK Marketpl,16.99,,16220.56
02/07/2018,DD,PRINCIPALITY BS,957.26,,16237.55
02/07/2018,DD,CC SWANSEA C.TAX,184,,17194.81
02/07/2018,DD,GOOD ENERGY LTD,97,,17378.81
02/07/2018,DD,AVIVA LIFE,46.46,,17475.81
02/07/2018,DD,DWR CYMRU W WATER,23.5,,17522.27
02/07/2018,SO,ESAVINGS ACCOUNT,300,,17545.77
02/07/2018,BP,SAVE THE CHANGE,1.32,,17845.77
02/07/2018,DEB,NON-STG PURCH FEE,0.5,,17847.09
02/07/2018,DEB,NON-STG TRANS FEE,7.16,,17847.59
02/07/2018,DEB,Hotel on Booking.c,239.51,,17854.75
29/06/2018,DEB,RYANAIR   224000,251.38,,18094.26
29/06/2018,DD,UCU B ACCOUNT,23.11,,18345.64
29/06/2018,DEB,NON-STG PURCH FEE,0.5,,18368.75
29/06/2018,DEB,NON-STG TRANS FEE,5.34,,18369.25
29/06/2018,DEB,Hotel on Booking.c,178.79,,18374.59
29/06/2018,BGC,SWANSEA UNI - PAY,,3200.58,18553.38
26/06/2018,BP,SAVE THE CHANGE,1.11,,15352.8
25/06/2018,DEB,MARKS&SPENCER PLC,2.5,,15353.91
25/06/2018,DEB,Audible.co.uk,7.99,,15356.41
25/06/2018,DEB,ARRIVA TRAINS WALE,96.4,,15364.4
25/06/2018,CPT,LNK UNI - UNIVERSI,50,,15460.8
25/06/2018,CPT,LNK M&S SWANSEA,60,,15510.8
22/06/2018,BP,SAVE THE CHANGE,0.03,,15570.8
22/06/2018,BGC,SWANSEA UNIVERSITY,,604.21,15570.83
21/06/2018,CPT,LNK GREATER ANGLIA,50,,14966.62
21/06/2018,DEB,AMAZON EU AMAZON.C,24.98,,15016.62
21/06/2018,DEB,AMAZON EU AMAZON.C,9.99,,15041.6
21/06/2018,DD,VIRGIN MEDIA PYMTS,27,,15051.59
18/06/2018,DD,O2,18.3,,15078.59
15/06/2018,CPT,LNK UNI - UNIVERSI,50,,15096.89
15/06/2018,BP,SAVE THE CHANGE,0.32,,15146.89
14/06/2018,DEB,NON-STG PURCH FEE,0.5,,15147.21
14/06/2018,DEB,NON-STG TRANS FEE,7.34,,15147.71
14/06/2018,DEB,HOTEL PRAGUE CASTL,245.68,,15155.05
12/06/2018,BP,SAVE THE CHANGE,1.91,,15400.73
11/06/2018,DEB,NON-STG PURCH FEE,0.5,,15402.64
11/06/2018,DEB,NON-STG TRANS FEE,10.83,,15403.14
11/06/2018,DEB,RECEPCE,362.21,,15413.97
11/06/2018,DEB,FOREIGN CASH FEE,1.5,,15776.18
11/06/2018,DEB,WILSONOVA 300/8,114.02,,15777.68
11/06/2018,DEB,NON-STG PURCH FEE,0.5,,15891.7
11/06/2018,DEB,NON-STG TRANS FEE,0.45,,15892.2
11/06/2018,DEB,BIOPOINT,15.37,,15892.65
11/06/2018,DEB,NON-STG PURCH FEE,0.5,,15908.02
11/06/2018,DEB,NON-STG TRANS FEE,0.22,,15908.52
11/06/2018,DEB,CD BRNO HL.N.,7.51,,15908.74
08/06/2018,DD,LV LIFE,37.12,,15916.25
06/06/2018,BP,SAVE THE CHANGE,0.95,,15953.37
05/06/2018,DEB,Acron Czech s.r.o.,95.05,,15954.32
04/06/2018,DEP,CLUB LLOYDS WAIVED,,3,16049.37
04/06/2018,PAY,CLUB LLOYDS FEE,3,,16046.37
04/06/2018,DD,ASSURANT INTER LTD,21.37,,16049.37
04/06/2018,BP,SAVE THE CHANGE,0.01,,16070.74
01/06/2018,,INTEREST (GROSS),,8.42,16070.75
01/06/2018,DEB,AMAZON SVCS EU-UK,11.99,,16062.33
01/06/2018,DD,PRINCIPALITY BS,957.26,,16074.32
01/06/2018,DD,CC SWANSEA C.TAX,184,,17031.58
01/06/2018,DD,GOOD ENERGY LTD,97,,17215.58
01/06/2018,DD,AVIVA LIFE,46.46,,17312.58
01/06/2018,DD,DWR CYMRU W WATER,23.5,,17359.04
01/06/2018,DD,ZURICH,19.36,,17382.54
01/06/2018,SO,ESAVINGS ACCOUNT,300,,17401.9
31/05/2018,DD,UCU B ACCOUNT,23.11,,17701.9
31/05/2018,BP,SAVE THE CHANGE,0.12,,17725.01
31/05/2018,BGC,SWANSEA UNI - PAY,,3200.58,17725.13
30/05/2018,DEB,RYANAIR   224000,208.88,,14524.55
30/05/2018,BP,SAVE THE CHANGE,1.7,,14733.43
29/05/2018,DEB,Amazon UK Marketpl,59.98,,14735.13
29/05/2018,DEB,Amazon UK Marketpl,3.07,,14795.11
29/05/2018,DEB,ROOT,4.25,,14798.18
29/05/2018,CPT,LNK 37 THE QUADANT,105.62,,14802.43
29/05/2018,CPT,LNK M&S SWANSEA,50,,14908.05
25/05/2018,CPT,LNK UNI - UNIVERSI,60,,14958.05
25/05/2018,BP,SAVE THE CHANGE,0.01,,15018.05
24/05/2018,DEB,Audible Ltd,7.99,,15018.06
23/05/2018,DEB,THE BIKE HUB,105,,15026.05
22/05/2018,BP,SAVE THE CHANGE,0.52,,15131.05
21/05/2018,DEB,Brontosaurus Vegan,19.48,,15131.57
21/05/2018,CPT,LNK UNI - UNIVERSI,50,,15151.05
21/05/2018,DD,VIRGIN MEDIA PYMTS,27,,15201.05
18/05/2018,CPT,LNK UNI - UNIVERSI,50,,15228.05
16/05/2018,DD,O2,26.54,,15278.05
16/05/2018,BP,SAVE THE CHANGE,0.05,,15304.59
15/05/2018,DEB,Amazon UK Marketpl,33.95,,15304.64
14/05/2018,FPI,BAMFORD C   ADGD,,33.45,15338.59
14/05/2018,CPT,LNK M&S SWANSEA,50,,15305.14
11/05/2018,CPT,LNK UNI - UNIVERSI,50,,15355.14
11/05/2018,DD,LV LIFE,37.12,,15405.14
11/05/2018,BP,SAVE THE CHANGE,0.53,,15442.26
10/05/2018,TFR,P M GREY,2500,,15442.79
10/05/2018,DEB,AMAZON EU AMAZON.C,39.47,,17942.79
09/05/2018,BP,SAVE THE CHANGE,0.03,,17982.26
08/05/2018,DEB,Amazon UK Marketpl,14.97,,17982.29
03/05/2018,DD,ASSURANT INTER LTD,21.37,,17997.26
03/05/2018,DD,PAYPAL PAYMENT,3.84,,18018.63
03/05/2018,BP,SAVE THE CHANGE,0.51,,18022.47
02/05/2018,DEB,Amazon UK Retail,24.49,,18022.98
02/05/2018,TFR,P M GREY,2000,,18047.47
01/05/2018,FEE,SILVER ACCOUNT,9.59,,20047.47
01/05/2018,,INTEREST (GROSS),,0.27,20057.06
01/05/2018,DD,PRINCIPALITY BS,957.26,,20056.79
01/05/2018,DD,CC SWANSEA C.TAX,184,,21014.05
01/05/2018,DD,GOOD ENERGY LTD,97,,21198.05
01/05/2018,DD,AVIVA LIFE,46.46,,21295.05
01/05/2018,DD,DWR CYMRU W WATER,23.5,,21341.51
01/05/2018,DD,ZURICH,19.36,,21365.01
01/05/2018,SO,ESAVINGS ACCOUNT,300,,21384.37
01/05/2018,BP,SAVE THE CHANGE,0.97,,21684.37
30/04/2018,DEB,Amazon UK Marketpl,21.03,,21685.34
30/04/2018,DD,UCU B ACCOUNT,23.11,,21706.37
30/04/2018,BP,SAVE THE CHANGE,0.11,,21729.48
30/04/2018,BGC,SWANSEA UNI - PAY,,3200.98,21729.59
30/04/2018,CPT,LOYD 802 OXFORD ST,50,,18528.61
27/04/2018,DEB,KLM UK  074532,260.89,,18578.61
27/04/2018,CPT,LNK UNI - UNIVERSI,60,,18839.5
27/04/2018,BP,SAVE THE CHANGE,0.12,,18899.5
26/04/2018,DEB,Amazon UK Marketpl,51.88,,18899.62
26/04/2018,DEB,EXPEDIA 7347956738,3,,18951.5
26/04/2018,BP,SAVE THE CHANGE,0.98,,18954.5
25/04/2018,DEB,AMAZON SVCS EU-UK,9.02,,18955.48
25/04/2018,CPT,LNK UNI - UNIVERSI,50,,18964.5
25/04/2018,BP,SAVE THE CHANGE,1.79,,19014.5
24/04/2018,DEB,Audible Ltd,7.99,,19016.29
24/04/2018,DEB,AMAZON EU AMAZON.C,5.39,,19024.28
24/04/2018,DEB,NON-STG PURCH FEE,0.5,,19029.67
24/04/2018,DEB,NON-STG TRANS FEE,1.05,,19030.17
24/04/2018,DEB,KLM FSSC BUD SCHI,35.16,,19031.22
24/04/2018,DEB,NON-STG PURCH FEE,0.5,,19066.38
24/04/2018,DEB,NON-STG TRANS FEE,0.28,,19066.88
24/04/2018,DEB,NS DELFT,9.67,,19067.16
24/04/2018,BP,SAVE THE CHANGE,0.72,,19076.83
23/04/2018,DEB,AMAZON SVCS EU-UK,8.79,,19077.55
23/04/2018,DEB,GOOGLE *YouTube Vi,3.49,,19086.34
23/04/2018,DD,VIRGIN MEDIA PYMTS,27,,19089.83
20/04/2018,DEB,NON-STG CASH FEE,1.5,,19116.83
20/04/2018,DEB,NON-STG TRANS FEE,3.91,,19118.33
20/04/2018,DEB,ABN-AMRO,130.85,,19122.24
20/04/2018,DEB,NON-STG CASH FEE,1.5,,19253.09
20/04/2018,DEB,NON-STG TRANS FEE,5.21,,19254.59
20/04/2018,DEB,ABN-AMRO,174.47,,19259.8
20/04/2018,DEB,NON-STG CASH FEE,1.5,,19434.27
20/04/2018,DEB,NON-STG TRANS FEE,5.21,,19435.77
20/04/2018,DEB,ABN-AMRO,174.47,,19440.98
20/04/2018,DEB,NON-STG CASH FEE,1.5,,19615.45
20/04/2018,DEB,NON-STG TRANS FEE,1.3,,19616.95
20/04/2018,DEB,ABN-AMRO,43.62,,19618.25
19/04/2018,BP,SAVE THE CHANGE,0.31,,19661.87
18/04/2018,DEB,NON-STG PURCH FEE,0.5,,19662.18
18/04/2018,DEB,NON-STG TRANS FEE,0.61,,19662.68
18/04/2018,DEB,PLUS 488,20.69,,19663.29
17/04/2018,BP,SAVE THE CHANGE,1.02,,19683.98
16/04/2018,DEB,NON-STG PURCH FEE,0.5,,19685
16/04/2018,DEB,NON-STG TRANS FEE,0.28,,19685.5
16/04/2018,DEB,NS SCHIPHOL,9.53,,19685.78
16/04/2018,DEB,AMAZON EU AMAZON.C,22.45,,19695.31
16/04/2018,DD,O2,23.18,,19717.76
16/04/2018,CPT,LNK ARRIVA TRAINS,40,,19740.94
16/04/2018,FPO,DEZREZ LEGAL LTD,25.8,,19780.94
13/04/2018,CPT,LNK UNI - UNIVERSI,100,,19806.74
12/04/2018,BP,SAVE THE CHANGE,1.1,,19906.74
11/04/2018,DEB,AMAZON SVCS EU-UK,1.74,,19907.84
11/04/2018,DEB,AMAZON SVCS EU-UK,18.16,,19909.58
10/04/2018,CPT,LNK UNI - UNIVERSI,50,,19927.74
10/04/2018,BP,SAVE THE CHANGE,2.34,,19977.74
09/04/2018,DEB,B & Q 1213,32.67,,19980.08
09/04/2018,DEB,AMAZON SVCS EU-UK,31.58,,20012.75
09/04/2018,DEB,AMAZON SVCS EU-UK,21.03,,20044.33
09/04/2018,DEB,Amazon UK Marketpl,16.55,,20065.36
09/04/2018,DEB,AMAZON EU AMAZON.C,13.85,,20081.91
09/04/2018,DEB,T K MAXX,12.98,,20095.76
09/04/2018,DD,LV LIFE,37.12,,20108.74
09/04/2018,BP,SAVE THE CHANGE,0.1,,20145.86
06/04/2018,DEB,AMAZON SVCS EU-UK,15.9,,20145.96
05/04/2018,DD,ZURICH,19.36,,20161.86
05/04/2018,BP,SAVE THE CHANGE,0.01,,20181.22
04/04/2018,DEB,AMAZON SVCS EU-UK,78.99,,20181.23
04/04/2018,BP,SAVE THE CHANGE,0.94,,20260.22
03/04/2018,FEE,ACCOUNT FEE,9.95,,20261.16
03/04/2018,DEB,AMAZON EU AMAZON.C,69.99,,20271.11
03/04/2018,DEB,AMAZON SVCS EU-UK,5.48,,20341.1
03/04/2018,DEB,AMAZON SVCS EU-UK,3.59,,20346.58
03/04/2018,DD,PRINCIPALITY BS,957.26,,20350.17
03/04/2018,DD,CC SWANSEA C.TAX,179.97,,21307.43
03/04/2018,DD,GOOD ENERGY LTD,97,,21487.4
03/04/2018,DD,AVIVA LIFE,46.46,,21584.4
03/04/2018,DD,ASSURANT INTER LTD,21.37,,21630.86
03/04/2018,SO,ESAVINGS ACCOUNT,300,,21652.23
03/04/2018,BGC,SWANSEA UNIVERSITY,,175.7,21952.23
03/04/2018,FPI,PAYPAL CODE 3241,,0.01,21776.53
03/04/2018,CPT,LNK M&S SWANSEA,50,,21776.52
29/03/2018,DD,UCU B ACCOUNT,23.11,,21826.52
29/03/2018,BGC,SWANSEA UNI - PAY,,3180.97,21849.63
27/03/2018,CPT,LNK UNI - UNIVERSI,50,,18668.66
27/03/2018,BP,SAVE THE CHANGE,0.08,,18718.66
26/03/2018,DEB,AMAZON SVCS EU-UK,45.99,,18718.74
26/03/2018,DEB,AMAZON SVCS EU-UK,6.99,,18764.73
26/03/2018,DEB,AMAZON SVCS EU-UK,6.95,,18771.72
26/03/2018,DEB,Audible Ltd,7.99,,18778.67
26/03/2018,BP,SAVE THE CHANGE,1.72,,18786.66
26/03/2018,CPT,LNK M&S SWANSEA,50,,18788.38
23/03/2018,DEB,AMAZON SVCS EU-UK,21.03,,18838.38
23/03/2018,DEB,AMAZON SVCS EU-UK,8.25,,18859.41
23/03/2018,CPT,LNK UNI - UNIVERSI,50,,18867.66
21/03/2018,DD,VIRGIN MEDIA PYMTS,27,,18917.66
20/03/2018,BP,SAVE THE CHANGE,1.27,,18944.66
19/03/2018,DEB,AMAZON SVCS EU-UK,14.99,,18945.93
19/03/2018,DEB,Amazon UK Marketpl,3.65,,18960.92
19/03/2018,DEB,KLM UK  074532,224.09,,18964.57
19/03/2018,BP,SAVE THE CHANGE,1.78,,19188.66
19/03/2018,CPT,LOYD 802 OXFORD ST,50,,19190.44
19/03/2018,CHQ,LOYD 802 OXFORD ST,,79.05,19240.44
16/03/2018,DEB,Amazon *Mktplce EU,10.12,,19161.39
16/03/2018,DEB,EXPEDIA 7337347949,2.1,,19171.51
16/03/2018,CPT,LNK UNI - UNIVERSI,60,,19173.61
16/03/2018,DD,O2,17.26,,19233.61
15/03/2018,BP,SAVE THE CHANGE,0.32,,19250.87
14/03/2018,DEB,AMAZON EU AMAZON.C,17.68,,19251.19
13/03/2018,BP,SAVE THE CHANGE,0.65,,19268.87
12/03/2018,DEB,GOOGLE *YouTube Vi,3.49,,19269.52
12/03/2018,DEB,Amazon UK Marketpl,42.95,,19273.01
12/03/2018,DEB,AMAZON MKTPLACE PM,17.91,,19315.96
09/03/2018,DEB,Amazon Prime,79,,19333.87
09/03/2018,DD,LV LIFE,37.12,,19412.87
07/03/2018,BP,SAVE THE CHANGE,0.97,,19449.99
06/03/2018,DEB,AMAZON SVCS EU-UK,21.03,,19450.96
06/03/2018,DD,ASSURANT INTER LTD,21.37,,19471.99
06/03/2018,BP,SAVE THE CHANGE,0.46,,19493.36
05/03/2018,DEB,Amazon UK Marketpl,94.54,,19493.82
05/03/2018,DEB,Amazon UK Marketpl,32,,19588.36
05/03/2018,BP,SAVE THE CHANGE,0.25,,19620.36
02/03/2018,DEB,BLS*WWWPLEDGEMUSIC,14.75,,19620.61
02/03/2018,BP,SAVE THE CHANGE,0.85,,19635.36
01/03/2018,FEE,ACCOUNT FEE,9.95,,19636.21
01/03/2018,DEB,AMAZON SVCS EU-UK,46,,19646.16
01/03/2018,DEB,AMAZON SVCS EU-UK,16.76,,19692.16
01/03/2018,DEB,AMAZON MKTPLACE PM,13.39,,19708.92
01/03/2018,DD,PRINCIPALITY BS,957.26,,19722.31
01/03/2018,DD,CC SWANSEA C.TAX,580,,20679.57
01/03/2018,DD,GOOD ENERGY LTD,85,,21259.57
01/03/2018,DD,AVIVA LIFE,46.46,,21344.57
01/03/2018,DD,DWR CYMRU W WATER,33.5,,21391.03
01/03/2018,DD,ZURICH,19.36,,21424.53
01/03/2018,SO,ESAVINGS ACCOUNT,300,,21443.89
28/02/2018,DD,UCU B ACCOUNT,23.11,,21743.89
28/02/2018,BP,SAVE THE CHANGE,0.55,,21767
28/02/2018,BGC,SWANSEA UNI - PAY,,3180.97,21767.55
28/02/2018,BGC,MIDDLESEX UNIV,,357.99,18586.58
27/02/2018,DEB,Amazon UK Marketpl,12.45,,18228.59
27/02/2018,BP,SAVE THE CHANGE,0.53,,18241.04
26/02/2018,DEB,AMAZON SVCS EU-UK,11.49,,18241.57
26/02/2018,DEB,Amazon UK Marketpl,9.99,,18253.06
26/02/2018,DEB,Audible Ltd,7.99,,18263.05
26/02/2018,DEB,AMAZON EU AMAZON.C,,18.6,18271.04
23/02/2018,CPT,LNK UNI - UNIVERSI,20,,18252.44
23/02/2018,BGC,SWANSEA UNIVERSITY,,724.39,18272.44
22/02/2018,CPT,LNK UNI - UNIVERSI,50,,17548.05
22/02/2018,BP,SAVE THE CHANGE,0.1,,17598.05
21/02/2018,DEB,AMAZON SVCS EU-UK,15.9,,17598.15
21/02/2018,DD,VIRGIN MEDIA PYMTS,27,,17614.05
20/02/2018,BP,SAVE THE CHANGE,1.94,,17641.05
19/02/2018,DEB,Amazon UK Retail,19.38,,17642.99
19/02/2018,DEB,AMAZON EU AMAZON.C,18.6,,17662.37
19/02/2018,DEB,Amazon UK Marketpl,2.08,,17680.97
19/02/2018,CPT,LNK UNI - UNIVERSI,40,,17683.05
16/02/2018,CPT,LNK UNI - UNIVERSI,40,,17723.05
16/02/2018,DD,O2,17.26,,17763.05
15/02/2018,BP,SAVE THE CHANGE,0.55,,17780.31
14/02/2018,DEB,Amazon UK Marketpl,17.45,,17780.86
14/02/2018,DEB,Amazon UK Retail,6,,17798.31
14/02/2018,CPT,LNK UNI - UNIVERSI,50,,17804.31
14/02/2018,BP,SAVE THE CHANGE,0.37,,17854.31
13/02/2018,DEB,Amazon UK Marketpl,108.98,,17854.68
13/02/2018,DEB,AMAZON SVCS EU-UK,3.65,,17963.66
12/02/2018,BP,SAVE THE CHANGE,0.21,,17967.31
09/02/2018,DEB,AMAZON SVCS EU-UK,21.79,,17967.52
09/02/2018,CPT,LNK UNI - UNIVERSI,40,,17989.31
09/02/2018,DD,LV LIFE,37.12,,18029.31
07/02/2018,CPT,LNK UNI - UNIVERSI,40,,18066.43
07/02/2018,CHQ,LOYD 802 OXFORD ST,,2.72,18106.43
07/02/2018,BP,SAVE THE CHANGE,0.63,,18103.71
06/02/2018,DEB,AMAZON SVCS EU-UK,16.89,,18104.34
06/02/2018,DEB,AMAZON SVCS EU-UK,14.48,,18121.23
06/02/2018,DD,ASSURANT INTER LTD,21.37,,18135.71
06/02/2018,BP,SAVE THE CHANGE,0.01,,18157.08
05/02/2018,DEB,AMAZON SVCS EU-UK,39.99,,18157.09
05/02/2018,DEB,BIRMINGHAM INT HOT,37,,18197.08
05/02/2018,CPT,LNK UNI - UNIVERSI,50,,18234.08
05/02/2018,BP,SAVE THE CHANGE,0.6,,18284.08
02/02/2018,DEB,AMAZON SVCS EU-UK,17.4,,18284.68
02/02/2018,BP,SAVE THE CHANGE,0.8,,18302.08
01/02/2018,FEE,ACCOUNT FEE,9.95,,18302.88
01/02/2018,DEB,DELIVEROOCOUK,23.2,,18312.83
01/02/2018,DD,PRINCIPALITY BS,957.26,,18336.03
01/02/2018,DD,CC SWANSEA C.TAX,580.73,,19293.29
01/02/2018,DD,GOOD ENERGY LTD,85,,19874.02
01/02/2018,DD,AVIVA LIFE,46.46,,19959.02
01/02/2018,DD,DWR CYMRU W WATER,33.5,,20005.48
01/02/2018,DD,ZURICH,19.36,,20038.98
01/02/2018,SO,ESAVINGS ACCOUNT,300,,20058.34
01/02/2018,BP,SAVE THE CHANGE,0.01,,20358.34
31/01/2018,DEB,AMAZON SVCS EU-UK,19.99,,20358.35
31/01/2018,DD,UCU B ACCOUNT,23.11,,20378.34
31/01/2018,BP,SAVE THE CHANGE,1.1,,20401.45
31/01/2018,BGC,SWANSEA UNI - PAY,,3180.98,20402.55
30/01/2018,DEB,GWR WEBSALES,65.4,,17221.57
30/01/2018,DEB,GWR WEBSALES,32,,17286.97
30/01/2018,DEB,GWR WEBSALES,12.5,,17318.97
30/01/2018,CPT,LNK UNI - UNIVERSI,100,,17331.47
29/01/2018,DEB,AMZ*Amazon.co.uk,,0.94,17431.47
29/01/2018,BP,SAVE THE CHANGE,1.05,,17430.53
26/01/2018,DEB,Amazon UK Retail,13.6,,17431.58
26/01/2018,DEB,Amazon UK Marketpl,5.49,,17445.18
26/01/2018,DEB,Amazon UK Marketpl,2.86,,17450.67
24/01/2018,BP,SAVE THE CHANGE,1.28,,17453.53
23/01/2018,DEB,JS ONLINE GROCERY,196.22,,17454.81
23/01/2018,DEB,IKEA ONLINE,124,,17651.03
23/01/2018,DEB,ETSY.COM - AURAGRA,20.5,,17775.03
23/01/2018,DEB,JS ONLINE GROCERY,,1.3,17795.53
23/01/2018,BP,SAVE THE CHANGE,0.86,,17794.23
22/01/2018,DEB,Amazon *Mktplce EU,9.14,,17795.09
22/01/2018,CPT,LNK UNI - UNIVERSI,50,,17804.23
22/01/2018,DD,VIRGIN MEDIA PYMTS,27,,17854.23
19/01/2018,CPT,LNK UNI - UNIVERSI,50,,17881.23
17/01/2018,DEB,BIRMINGHAM INT HOT,,28,17931.23
17/01/2018,CPT,LNK UNI - UNIVERSI,40,,17903.23
17/01/2018,BP,SAVE THE CHANGE,2.9,,17943.23
16/01/2018,DEB,GWR WEBSALES,148.2,,17946.13
16/01/2018,DEB,QUEENS HOTEL,87.3,,18094.33
16/01/2018,DEB,ARRIVA TRAINS WALE,62.4,,18181.63
16/01/2018,DEB,WEST COAST TRAINS,62.2,,18244.03
16/01/2018,DEB,BIRMINGHAM INT HOT,28,,18306.23
16/01/2018,DD,O2,17.26,,18334.23
16/01/2018,BP,SAVE THE CHANGE,0.97,,18351.49
15/01/2018,DEB,AMAZON EU AMAZON.C,6,,18352.46
15/01/2018,DEB,AMAZON EU AMAZON.C,6,,18358.46
15/01/2018,DEB,Amazon UK Marketpl,5.82,,18364.46
15/01/2018,DEB,AMAZON EU AMAZON.C,5.21,,18370.28
15/01/2018,BP,SAVE THE CHANGE,0.2,,18375.49
12/01/2018,DEB,ARRIVA TRAINS WALE,23.8,,18375.69
12/01/2018,CPT,LNK UNI - UNIVERSI,50,,18399.49
12/01/2018,BP,SAVE THE CHANGE,0.8,,18449.49
11/01/2018,DEB,DELIVEROOCOUK,22.2,,18450.29
11/01/2018,CPT,LNK ARRIVA TRAINS,40,,18472.49
11/01/2018,BP,SAVE THE CHANGE,1.62,,18512.49
10/01/2018,DEB,Amazon UK Marketpl,14.99,,18514.11
10/01/2018,DEB,Amazon UK Marketpl,3.09,,18529.1
10/01/2018,DEB,Amazon UK Marketpl,1.3,,18532.19
10/01/2018,DEB,BRITANNIA,28,,18533.49
09/01/2018,CPT,LNK UNI - UNIVERSI,40,,18561.49
09/01/2018,BP,SAVE THE CHANGE,0.03,,18601.49
08/01/2018,DEB,Amazon UK Marketpl,10.98,,18601.52
08/01/2018,DEB,Amazon UK Marketpl,5.99,,18612.5
08/01/2018,DD,LV LIFE,37.12,,18618.49
08/01/2018,BP,SAVE THE CHANGE,1.06,,18655.61
05/01/2018,DEB,Amazon UK Marketpl,29.96,,18656.67
05/01/2018,DEB,Amazon UK Marketpl,6.94,,18686.63
05/01/2018,DEB,Amazon UK Marketpl,6.04,,18693.57
05/01/2018,CPT,LNK UNI - UNIVERSI,50,,18699.61
04/01/2018,DD,ZURICH,19.36,,18749.61
03/01/2018,DD,ASSURANT INTER LTD,21.37,,18768.97
03/01/2018,BP,SAVE THE CHANGE,1.19,,18790.34
02/01/2018,FEE,ACCOUNT FEE,9.95,,18791.53
02/01/2018,DEB,Amazon UK Marketpl,5.55,,18801.48
02/01/2018,DEB,Amazon UK Marketpl,6.99,,18807.03
02/01/2018,DEB,NON-STG PURCH FEE,0.5,,18814.02
02/01/2018,DEB,NON-STG TRANS FEE,2.16,,18814.52
02/01/2018,DEB,ATHLEAN-X,72.27,,18816.68
02/01/2018,DD,PRINCIPALITY BS,957.26,,18888.95
02/01/2018,DD,GOOD ENERGY LTD,85,,19846.21
02/01/2018,DD,AVIVA LIFE,46.46,,19931.21
02/01/2018,DD,DWR CYMRU W WATER,33.5,,19977.67
02/01/2018,SO,ESAVINGS ACCOUNT,300,,20011.17
02/01/2018,BP,SAVE THE CHANGE,0.98,,20311.17
02/01/2018,DEB,NON-STG PURCH FEE,0.5,,20312.15
02/01/2018,DEB,NON-STG TRANS FEE,0.95,,20312.65
02/01/2018,DEB,REST JARDIM DAS CE,32.02,,20313.6
29/12/2017,DD,UCU B ACCOUNT,23.11,,20345.62
29/12/2017,BP,SAVE THE CHANGE,0.06,,20368.73
28/12/2017,DEB,FOREIGN CASH FEE,1.5,,20368.79
28/12/2017,DEB,Alegro Setubal-P1,96.75,,20370.29
28/12/2017,DEB,AMAZON MKTPLACE PM,17.94,,20467.04
27/12/2017,BP,SAVE THE CHANGE,0.47,,20484.98
22/12/2017,DEB,NON-STG PURCH FEE,0.5,,20485.45
22/12/2017,DEB,NON-STG TRANS FEE,1.54,,20485.95
22/12/2017,DEB,JUMBO SETUBAL,51.53,,20487.49
22/12/2017,BP,SAVE THE CHANGE,0.62,,20539.02
21/12/2017,DEB,AMAZON MKTPLACE PM,17.94,,20539.64
21/12/2017,DEB,GODADDY COM EUROPE,31.44,,20557.58
21/12/2017,DD,VIRGIN MEDIA PYMTS,27,,20589.02
21/12/2017,BP,SAVE THE CHANGE,0.26,,20616.02
20/12/2017,DEB,ARRIVA TRAINS WALE,73.8,,20616.28
20/12/2017,DEB,AMAZON MKTPLACE PM,17.94,,20690.08
20/12/2017,BP,SAVE THE CHANGE,0.62,,20708.02
20/12/2017,BGC,SWANSEA UNI - PAY,,3180.97,20708.64
19/12/2017,DEB,Amazon UK Marketpl,4.38,,17527.67
19/12/2017,BP,SAVE THE CHANGE,0.72,,17532.05
18/12/2017,DEB,GWR WEBSALES,269.3,,17532.77
18/12/2017,DEB,AMAZON EU AMAZON.C,23.99,,17802.07
18/12/2017,DEB,Amazon UK Marketpl,16.99,,17826.06
18/12/2017,CPT,LNK CAMBRIDGE STAT,50,,17843.05
18/12/2017,DD,O2,30.69,,17893.05
18/12/2017,BP,SAVE THE CHANGE,1.26,,17923.74
15/12/2017,DEB,Amazon UK Retail,8,,17925
15/12/2017,DEB,Amazon UK Marketpl,6.48,,17933
15/12/2017,DEB,Amazon UK Marketpl,4.98,,17939.48
15/12/2017,DEB,Amazon UK Marketpl,4.28,,17944.46
15/12/2017,CPT,LNK 37 THE QUADANT,96.15,,17948.74
15/12/2017,BP,SAVE THE CHANGE,0.8,,18044.89
14/12/2017,DEB,DELIVEROOCOUK,20.2,,18045.69
14/12/2017,CPT,LNK UNI - UNIVERSI,50,,18065.89
14/12/2017,BP,SAVE THE CHANGE,0.36,,18115.89
13/12/2017,DEB,Amazon UK Retail,20.64,,18116.25
12/12/2017,CPT,LNK UNI - UNIVERSI,100,,18136.89
11/12/2017,BP,SAVE THE CHANGE,0.11,,18236.89
11/12/2017,CPT,LNK UNI - UNIVERSI,50,,18237
08/12/2017,DEB,Amazon UK Marketpl,12.94,,18287
08/12/2017,DEB,Amazon UK Marketpl,9.95,,18299.94
08/12/2017,CPT,LNK UNI - UNIVERSI,50,,18309.89
08/12/2017,DD,LV LIFE,37.12,,18359.89
08/12/2017,BP,SAVE THE CHANGE,1.19,,18397.01
08/12/2017,BGC,SWANSEA UNIVERSITY,,192.05,18398.2
07/12/2017,DEB,Amazon UK Retail,18.6,,18206.15
07/12/2017,DEB,Amazon UK Marketpl,18.21,,18224.75
05/12/2017,CPT,LNK UNI - UNIVERSI,50,,18242.96
05/12/2017,DD,ASSURANT INTER LTD,21.37,,18292.96
05/12/2017,BP,SAVE THE CHANGE,0.94,,18314.33
04/12/2017,DEB,Amazon UK Marketpl,11.39,,18315.27
04/12/2017,DEB,Amazon UK Marketpl,9.67,,18326.66
04/12/2017,CPT,LNK UNI - UNIVERSI,50,,18336.33
04/12/2017,BP,SAVE THE CHANGE,0.21,,18386.33
01/12/2017,FEE,ACCOUNT FEE,9.95,,18386.54
01/12/2017,DEB,FUNKY FUTON CO LTD,483,,18396.49
01/12/2017,DEB,Amazon UK Retail,11.79,,18879.49
01/12/2017,DD,PRINCIPALITY BS,957.26,,18891.28
01/12/2017,DD,GOOD ENERGY LTD,85,,19848.54
01/12/2017,DD,AVIVA LIFE,46.46,,19933.54
01/12/2017,DD,DWR CYMRU W WATER,33.5,,19980
01/12/2017,DD,ZURICH,19.36,,20013.5
01/12/2017,SO,ESAVINGS ACCOUNT,300,,20032.86
30/11/2017,DD,UCU B ACCOUNT,23.11,,20332.86
30/11/2017,BGC,SWANSEA UNI - PAY,,3180.97,20355.97
30/11/2017,BGC,C C SWANSEA,,638.73,17175
29/11/2017,BP,SAVE THE CHANGE,0.55,,16536.27
28/11/2017,DEB,Amazon UK Marketpl,1.45,,16536.82
28/11/2017,BP,SAVE THE CHANGE,0.75,,16538.27
27/11/2017,DEB,AMAZON UK RETAIL A,14.25,,16539.02
22/11/2017,BGC,MIDDLESEX UNIV.,,217.99,16553.27
21/11/2017,CPT,LNK UNI - UNIVERSI,50,,16335.28
21/11/2017,DD,VIRGIN MEDIA PYMTS,27,,16385.28
21/11/2017,BP,SAVE THE CHANGE,2.05,,16412.28
20/11/2017,DEB,MOUNTAIN WAREHOUSE,34.99,,16414.33
20/11/2017,DEB,WAGAMAMA CARDIFF L,28.45,,16449.32
20/11/2017,DEB,AMAZON SVCS EU-UK,18.82,,16477.77
20/11/2017,DEB,Amazon UK Retail,16.76,,16496.59
20/11/2017,DEB,T K MAXX,12.97,,16513.35
20/11/2017,DEB,ODEON/BOOKIT,24,,16526.32
20/11/2017,DEB,Amazon UK Marketpl,18.71,,16550.32
20/11/2017,DEB,AMAZON EU AMAZON.C,13.92,,16569.03
20/11/2017,DEB,Amazon UK Marketpl,5.35,,16582.95
20/11/2017,DEB,Amazon UK Marketpl,4.98,,16588.3
20/11/2017,BP,SAVE THE CHANGE,0.33,,16593.28
17/11/2017,DEB,Amazon UK Marketpl,19.97,,16593.61
17/11/2017,DEB,DELIVEROOCOUK,22.7,,16613.58
17/11/2017,CPT,LNK UNI - UNIVERSI,50,,16636.28
16/11/2017,DD,O2,27.45,,16686.28
15/11/2017,BP,SAVE THE CHANGE,0.01,,16713.73
14/11/2017,DEB,Amazon UK Marketpl,7.99,,16713.74
14/11/2017,BP,SAVE THE CHANGE,0.99,,16721.73
13/11/2017,DEB,w1185123616,94.01,,16722.72
13/11/2017,BP,SAVE THE CHANGE,0.3,,16816.73
10/11/2017,DEB,DELIVEROOCOUK,21.7,,16817.03
10/11/2017,BP,SAVE THE CHANGE,0.38,,16838.73
09/11/2017,DEB,AMAZON SVCS EU-UK,14.62,,16839.11
09/11/2017,BP,SAVE THE CHANGE,0.96,,16853.73
08/11/2017,DEB,AMAZON SVCS EU-UK,29.05,,16854.69
08/11/2017,DEB,AMAZON SVCS EU-UK,16.99,,16883.74
08/11/2017,CPT,LNK UNI - UNIVERSI,50,,16900.73
08/11/2017,DD,LV LIFE,37.12,,16950.73
08/11/2017,BP,SAVE THE CHANGE,0.31,,16987.85
07/11/2017,DEB,AMAZON SVCS EU-UK,13.69,,16988.16
07/11/2017,BP,SAVE THE CHANGE,0.28,,17001.85
06/11/2017,DEB,AMAZON SVCS EU-UK,21.98,,17002.13
06/11/2017,DEB,GWR LON PADD TO,26.9,,17024.11
06/11/2017,DEB,LUL TICKET MACHINE,4.9,,17051.01
06/11/2017,DEB,AMAZON SVCS EU-UK,2.95,,17055.91
06/11/2017,DEB,AMAZON SVCS EU-UK,14.99,,17058.86
06/11/2017,CPT,LNK UNI - UNIVERSI,60,,17073.85
06/11/2017,BP,SAVE THE CHANGE,0.01,,17133.85
03/11/2017,DEB,AMAZON SVCS EU-UK,6.99,,17133.86
03/11/2017,DD,ASSURANT INTER LTD,21.37,,17140.85
03/11/2017,BGC,SWANSEA UNIVERSITY,,1554.87,17162.22
01/11/2017,FEE,ACCOUNT FEE,9.95,,15607.35
01/11/2017,DD,PRINCIPALITY BS,957.26,,15617.3
01/11/2017,DD,AVIVA LIFE,46.46,,16574.56
01/11/2017,DD,DWR CYMRU W WATER,33.5,,16621.02
01/11/2017,DD,ZURICH,19.36,,16654.52
01/11/2017,SO,ESAVINGS ACCOUNT,300,,16673.88
01/11/2017,BP,SAVE THE CHANGE,0.01,,16973.88
31/10/2017,DEB,Amazon UK Marketpl,7.99,,16973.89
31/10/2017,DD,UCU B ACCOUNT,23.11,,16981.88
31/10/2017,BP,SAVE THE CHANGE,2.73,,17004.99
31/10/2017,BGC,SWANSEA UNI - PAY,,3180.98,17007.72
30/10/2017,DEB,Amazon UK Marketpl,7.1,,13826.74
30/10/2017,DEB,AMAZON.CO.UK,5.74,,13833.84
30/10/2017,DEB,JS ONLINE GROCERY,244.2,,13839.58
30/10/2017,DEB,WWW.GOODENERGY.CO.,145.23,,14083.78
30/10/2017,BP,SAVE THE CHANGE,0.95,,14229.01
27/10/2017,DEB,DELIVEROOCOUK,20.05,,14229.96
27/10/2017,CPT,LNK UNI - UNIVERSI,60,,14250.01
27/10/2017,BGC,SWANSEA UNIVERSITY,,1245.34,14310.01
27/10/2017,BGC,MIDDLESEX UNIV,,140,13064.67
25/10/2017,BP,SAVE THE CHANGE,0.35,,12924.67
24/10/2017,DEB,AMAZON SVCS EU-UK,4.65,,12925.02
24/10/2017,CPT,LNK UNI - UNIVERSI,50,,12929.67
24/10/2017,BP,SAVE THE CHANGE,1.35,,12979.67
23/10/2017,DEB,IKEA ONLINE,75.4,,12981.02
23/10/2017,DEB,AMAZON SVCS EU-UK,2.85,,13056.42
23/10/2017,DEB,AMAZON EU AMAZON.C,15.4,,13059.27
23/10/2017,DD,VIRGIN MEDIA PYMTS,49,,13074.67
23/10/2017,BP,SAVE THE CHANGE,1.03,,13123.67
20/10/2017,DEB,Amazon UK Marketpl,15.77,,13124.7
20/10/2017,DEB,DELIVEROOCOUK,19.2,,13140.47
20/10/2017,CPT,LNK UNI - UNIVERSI,50,,13159.67
20/10/2017,BP,SAVE THE CHANGE,0.08,,13209.67
19/10/2017,DEB,Amazon UK Marketpl,14.93,,13209.75
19/10/2017,DEB,Amazon UK Marketpl,5.99,,13224.68
19/10/2017,BP,SAVE THE CHANGE,0.53,,13230.67
18/10/2017,DEB,Amazon UK Retail,7.49,,13231.2
18/10/2017,DEB,Amazon UK Marketpl,2.98,,13238.69
18/10/2017,DD,ZURICH,19.36,,13241.67
17/10/2017,CPT,LNK UNI - UNIVERSI,40,,13261.03
17/10/2017,BP,SAVE THE CHANGE,0.23,,13301.03
16/10/2017,DEB,Amazon UK Marketpl,7.77,,13301.26
16/10/2017,DD,O2,17.26,,13309.03
16/10/2017,BP,SAVE THE CHANGE,0.8,,13326.29
13/10/2017,DEB,DELIVEROOCOUK,20.2,,13327.09
13/10/2017,CPT,LNK UNI - UNIVERSI,20,,13347.29
13/10/2017,BP,SAVE THE CHANGE,0.05,,13367.29
12/10/2017,DEB,Amazon UK Retail,31.95,,13367.34
12/10/2017,BP,SAVE THE CHANGE,1.33,,13399.29
11/10/2017,DEB,Amazon UK Retail,14.99,,13400.62
11/10/2017,DEB,AMAZON.CO.UK,6.19,,13415.61
11/10/2017,DEB,AMAZON.CO.UK,4.49,,13421.8
11/10/2017,CHQ,LOYD 802 OXFORD ST,,383.47,13426.29
11/10/2017,BP,SAVE THE CHANGE,0.87,,13042.82
10/10/2017,DEB,Amazon UK Marketpl,4.38,,13043.69
10/10/2017,CPT,LNK UNI - UNIVERSI,50,,13048.07
10/10/2017,DEB,NON-STG PURCH FEE,0.5,,13098.07
10/10/2017,DEB,NON-STG TRANS FEE,32.4,,13098.57
10/10/2017,DEB,HYATT REGENCY PHOE,1083.75,,13130.97
09/10/2017,DD,LV LIFE,37.12,,14214.72
03/10/2017,FPI,MARIANA MILLS,,200,14251.84
03/10/2017,DD,ASSURANT INTER LTD,21.37,,14051.84
02/10/2017,FEE,ACCOUNT FEE,9.95,,14073.21
02/10/2017,DD,PRINCIPALITY BS,957.26,,14083.16
02/10/2017,DD,CC SWANSEA C.TAX,174,,15040.42
02/10/2017,DD,AVIVA LIFE,46.46,,15214.42
02/10/2017,DD,DWR CYMRU W WATER,33.5,,15260.88
02/10/2017,SO,ESAVINGS ACCOUNT,300,,15294.38
29/09/2017,CPT,LNK UNI - UNIVERSI,150,,15594.38
29/09/2017,DD,UCU B ACCOUNT,23.11,,15744.38
29/09/2017,BP,SAVE THE CHANGE,2.27,,15767.49
29/09/2017,BGC,SWANSEA UNI - PAY,,3180.97,15769.76
28/09/2017,DEB,ARRIVA TRAINS WALE,95.3,,12588.79
28/09/2017,DEB,BIRMINGHAM INT HOT,91.5,,12684.09
28/09/2017,DEB,WASABI BIRMINGHAM,28,,12775.59
28/09/2017,DEB,Amazon UK Marketpl,17.65,,12803.59
28/09/2017,DEB,AMAZON UK RETAIL A,12.99,,12821.24
28/09/2017,DEB,NON-STG PURCH FEE,0.5,,12834.23
28/09/2017,DEB,NON-STG TRANS FEE,1.11,,12834.73
28/09/2017,DEB,WPY*Klaus Mueller,37.29,,12835.84
27/09/2017,BP,SAVE THE CHANGE,2.1,,12873.13
26/09/2017,DEB,ARRIVA TRAINS WALE,8.4,,12875.23
26/09/2017,DEB,Amazon UK Marketpl,6.01,,12883.63
26/09/2017,DEB,Amazon UK Marketpl,4.99,,12889.64
26/09/2017,DEB,Amazon UK Marketpl,2.99,,12894.63
26/09/2017,DEB,Amazon UK Marketpl,2.51,,12897.62
25/09/2017,FPI,MARIANA MILLS,,180,12900.13
25/09/2017,CPT,LNK UNI - UNIVERSI,100,,12720.13
25/09/2017,BP,SAVE THE CHANGE,0.86,,12820.13
22/09/2017,DEB,EASYJET   ESVS7J,380.94,,12820.99
22/09/2017,DEB,Amazon UK Marketpl,2,,13201.93
22/09/2017,DEB,DELIVEROOCOUK,20.2,,13203.93
22/09/2017,CPT,LNK UNI - UNIVERSI,50,,13224.13
22/09/2017,BP,SAVE THE CHANGE,1.08,,13274.13
21/09/2017,DEB,WATSON & PRATTS,140.67,,13275.21
21/09/2017,DEB,Amazon UK Marketpl,6.25,,13415.88
21/09/2017,BP,SAVE THE CHANGE,0.01,,13422.13
20/09/2017,DEB,Amazon UK Retail,12.99,,13422.14
19/09/2017,CPT,LNK UNI - UNIVERSI,50,,13435.13
19/09/2017,BP,SAVE THE CHANGE,0.5,,13485.13
18/09/2017,DEB,BIRMINGHAM INT HOT,47.5,,13485.63
18/09/2017,DD,O2,29.36,,13533.13
18/09/2017,CPT,LNK ARRIVA TRAINS,50,,13562.49
14/09/2017,DEB,ARRIVA TRAINS WALE,89,,13612.49
13/09/2017,BP,SAVE THE CHANGE,0.52,,13701.49
12/09/2017,DEB,Amazon UK Marketpl,1.48,,13702.01
12/09/2017,CPT,LNK UNI - UNIVERSI,50,,13703.49
12/09/2017,BP,SAVE THE CHANGE,0.2,,13753.49
11/09/2017,DEB,IZ *Brontosaurus V,31.8,,13753.69
11/09/2017,CPT,LNK UNI - UNIVERSI,50,,13785.49
11/09/2017,BP,SAVE THE CHANGE,1.2,,13835.49
11/09/2017,TFR,SERGEJS KATACINS,35,,13836.69
08/09/2017,DEB,PLUSNET PLC 0845 1,41.6,,13871.69
08/09/2017,DEB,DELIVEROOCOUK,19.2,,13913.29
08/09/2017,DD,LV LIFE,37.12,,13932.49
08/09/2017,BP,SAVE THE CHANGE,0.99,,13969.61
07/09/2017,DEB,BRITISH GAS TRADIN,83.66,,13970.6
07/09/2017,DEB,BRITISH GAS TRADIN,49.35,,14054.26
06/09/2017,BP,SAVE THE CHANGE,0.64,,14103.61
05/09/2017,CPT,LNK SWANSEA WIND S,200,,14104.25
05/09/2017,DEB,Amazon UK Marketpl,26.87,,14304.25
05/09/2017,DEB,Amazon UK Marketpl,2.49,,14331.12
05/09/2017,BP,SAVE THE CHANGE,2.77,,14333.61
04/09/2017,CPT,LNK 1 UNION STREET,100,,14336.38
04/09/2017,DEB,Amazon UK Marketpl,63.13,,14436.38
04/09/2017,DEB,Amazon UK Marketpl,10.14,,14499.51
04/09/2017,DEB,Amazon UK Retail,4.62,,14509.65
04/09/2017,DEB,TICKETS08712200260,95.34,,14514.27
04/09/2017,DEB,HENDON HALL HOTEL,114,,14609.61
04/09/2017,DD,ASSURANT INTER LTD,21.47,,14723.61
04/09/2017,BP,SAVE THE CHANGE,0.7,,14745.08
04/09/2017,TFR,SERGEJS KATACINS,182,,14745.78
01/09/2017,FEE,ACCOUNT FEE,9.95,,14927.78
01/09/2017,DEB,ARRIVA TRAINS WALE,82.3,,14937.73
01/09/2017,DD,PRINCIPALITY BS,957.26,,15020.03
01/09/2017,DD,CC SWANSEA C.TAX,174,,15977.29
01/09/2017,DD,AVIVA LIFE,46.46,,16151.29
01/09/2017,DD,DWR CYMRU W WATER,33.5,,16197.75
01/09/2017,SO,ESAVINGS ACCOUNT,300,,16231.25
31/08/2017,CPT,LNK UNI - UNIVERSI,50,,16531.25
31/08/2017,DD,UCU B ACCOUNT,22.7,,16581.25
31/08/2017,BP,SAVE THE CHANGE,0.41,,16603.95
31/08/2017,BGC,SWANSEA UNI - PAY,,3180.97,16604.36
30/08/2017,DEB,Amazon UK Marketpl,18.59,,13423.39
30/08/2017,BP,SAVE THE CHANGE,0.24,,13441.98
29/08/2017,DEB,Amazon UK Retail,23.76,,13442.22
29/08/2017,DEB,PLUSNET PLC 0845 1,,5.07,13465.98
29/08/2017,CPT,LNK UNI - UNIVERSI,50,,13460.91
25/08/2017,DEB,VIRGIN MEDIA PYMTS,25,,13510.91
25/08/2017,BP,SAVE THE CHANGE,0.15,,13535.91
24/08/2017,DEB,4500 MILES,28.85,,13536.06
24/08/2017,BGC,PLUSNET PLC PAY AC,,9,13564.91
23/08/2017,CPT,LNK TESCO BLEN CRT,30,,13555.91
23/08/2017,BP,SAVE THE CHANGE,0.1,,13585.91
22/08/2017,DEB,THE LANGLEY ARMS,150,,13586.01
22/08/2017,DEB,ARRIVA TRAINS WALE,36.9,,13736.01
21/08/2017,CPT,LNK ARRIVA TRAINS,60,,13772.91
21/08/2017,DEB,IKEA ONLINE,194,,13832.91
21/08/2017,DEB,AMZ*Globoshop,,48.99,14026.91
18/08/2017,CPT,LNK UNI - UNIVERSI,50,,13977.92
17/08/2017,CPT,LNK ARRIVA TRAINS,60,,14027.92
17/08/2017,DD,PNET3444685-1,18.99,,14087.92
16/08/2017,CPT,LNK UNI - UNIVERSI,250,,14106.91
16/08/2017,DD,O2,24.42,,14356.91
16/08/2017,DD,PNET3444685-1,9,,14381.33
16/08/2017,BP,SAVE THE CHANGE,0.05,,14390.33
15/08/2017,DEB,AMAZON UK RETAIL A,23.95,,14390.38
15/08/2017,CPT,LNK UNI - UNIVERSI,80,,14414.33
15/08/2017,BP,SAVE THE CHANGE,0.01,,14494.33
14/08/2017,DEB,AMAZON.CO.UK,11.99,,14494.34
14/08/2017,DEB,BRITANNIA,49,,14506.33
11/08/2017,DEB,AMZ*Discounted Cle,,10.58,14555.33
11/08/2017,CHQ,52,90,,14544.75
11/08/2017,BP,SAVE THE CHANGE,0.04,,14634.75
10/08/2017,CPT,LNK TESCO SWANSEA,60,,14634.79
10/08/2017,DEB,Amazon UK Retail,15.96,,14694.79
10/08/2017,BP,SAVE THE CHANGE,0.51,,14710.75
09/08/2017,DEB,Amazon UK Retail,5.49,,14711.26
09/08/2017,DD,LV LIFE,37.12,,14716.75
09/08/2017,BP,SAVE THE CHANGE,0.81,,14753.87
08/08/2017,DEB,Amazon UK Marketpl,8.39,,14754.68
08/08/2017,DEB,THE HEALTH SHOP,38.8,,14763.07
08/08/2017,CPT,LNK UNI - UNIVERSI,50,,14801.87
08/08/2017,BP,SAVE THE CHANGE,0.81,,14851.87
07/08/2017,DEB,IZ *Brontosaurus V,16.19,,14852.68
07/08/2017,BP,SAVE THE CHANGE,2.57,,14868.87
07/08/2017,DEB,NON-STG PURCH FEE,0.5,,14871.44
07/08/2017,DEB,NON-STG TRANS FEE,5.36,,14871.94
07/08/2017,DEB,HYATT REGENCY PHOE,179.44,,14877.3
04/08/2017,DEB,Amazon UK Marketpl,6.26,,15056.74
04/08/2017,DEB,Amazon UK Retail,5.46,,15063
04/08/2017,DEB,Amazon UK Marketpl,5.27,,15068.46
04/08/2017,CPT,LNK UNI - UNIVERSI,50,,15073.73
04/08/2017,DD,ASSURANT INTER LTD,39.74,,15123.73
04/08/2017,BP,SAVE THE CHANGE,0.71,,15163.47
03/08/2017,DEB,THE PRINCIPAL MANC,267.3,,15164.18
03/08/2017,DEB,Amazon UK Marketpl,48.99,,15431.48
03/08/2017,DEB,AMZ*Dealsdirect247,,15.99,15480.47
03/08/2017,BP,SAVE THE CHANGE,0.9,,15464.48
02/08/2017,DEB,SPRINGFIELD DEVELO,160,,15465.38
02/08/2017,DEB,SWANSEA UNI - CATE,3.1,,15625.38
02/08/2017,BP,SAVE THE CHANGE,0.4,,15628.48
01/08/2017,FEE,ACCOUNT FEE,9.95,,15628.88
01/08/2017,DEB,GWR WEBSALES,78.6,,15638.83
01/08/2017,CPT,LNK 404331M&S SWAN,80,,15717.43
01/08/2017,DD,PRINCIPALITY BS,1159.25,,15797.43
01/08/2017,DD,CC SWANSEA C.TAX,174,,16956.68
01/08/2017,DD,AVIVA LIFE,46.46,,17130.68
01/08/2017,DD,DWR CYMRU W WATER,33.5,,17177.14
01/08/2017,SO,ESAVINGS ACCOUNT,300,,17210.64
01/08/2017,BP,SAVE THE CHANGE,1.89,,17510.64
31/07/2017,DEB,Amazon UK Marketpl,26.25,,17512.53
31/07/2017,DEB,Amazon UK Marketpl,1.27,,17538.78
31/07/2017,DEB,IKEA ONLINE,360,,17540.05
31/07/2017,DEB,CITY PLUMBING SUPP,153.59,,17900.05
31/07/2017,DD,UCU B ACCOUNT,22.7,,18053.64
31/07/2017,BP,SAVE THE CHANGE,0.82,,18076.34
31/07/2017,BGC,SWANSEA UNI - PAY,,3138.66,18077.16
28/07/2017,DEB,AMAZON.CO.UK,11.96,,14938.5
28/07/2017,DEB,AMAZON UK RETAIL A,7.38,,14950.46
28/07/2017,DEB,AMAZON.CO.UK,13.84,,14957.84
28/07/2017,CPT,LNK UNI - UNIVERSI,50,,14971.68
25/07/2017,CPT,LNK UNI - UNIVERSI,50,,15021.68
21/07/2017,CPT,LNK UNI - UNIVERSI,50,,15071.68
21/07/2017,DD,VIRGIN MEDIA PYMTS,30.97,,15121.68
21/07/2017,BGC,SWANSEA UNIVERSITY,,1004.43,15152.65
20/07/2017,DD,GOOD ENERGY LTD,124.74,,14148.22
19/07/2017,CPT,LNK UNI - UNIVERSI,50,,14272.96
17/07/2017,DD,O2,26.73,,14322.96
14/07/2017,BP,SAVE THE CHANGE,0.5,,14349.69
13/07/2017,DEB,Amazon UK Marketpl,6.5,,14350.19
13/07/2017,DD,AVIVA LIFE,46.46,,14356.69
13/07/2017,BP,SAVE THE CHANGE,0.98,,14403.15
12/07/2017,DEB,Amazon UK Marketpl,10.66,,14404.13
12/07/2017,DEB,Amazon UK Marketpl,10.36,,14414.79
12/07/2017,BP,SAVE THE CHANGE,0.44,,14425.15
11/07/2017,DEB,PLUSNET PLC 0845 1,68.98,,14425.59
11/07/2017,DEB,Amazon UK Marketpl,10.58,,14494.57
11/07/2017,BP,SAVE THE CHANGE,1.18,,14505.15
10/07/2017,DEB,Amazon UK Retail,13.66,,14506.33
10/07/2017,DEB,Amazon UK Retail,17.84,,14519.99
10/07/2017,DEB,Amazon UK Marketpl,2.62,,14537.83
10/07/2017,DEB,Amazon UK Marketpl,1.7,,14540.45
10/07/2017,DD,LVFS LTD A A/C,37.12,,14542.15
07/07/2017,CPT,LNK UNI - UNIVERSI,100,,14579.27
07/07/2017,CHQ,LOYD 802 OXFORD ST,,1003.79,14679.27
07/07/2017,BP,SAVE THE CHANGE,0.22,,13675.48
06/07/2017,DEB,Amazon UK Marketpl,16.78,,13675.7
06/07/2017,TFR,F/FLOW NATWEST BAN,,828.49,13692.48
06/07/2017,CPT,LNK UNI - UNIVERSI,200,,12863.99
06/07/2017,BP,SAVE THE CHANGE,0.56,,13063.99
05/07/2017,DEB,Amazon UK Marketpl,14.44,,13064.55
05/07/2017,BP,SAVE THE CHANGE,0.01,,13078.99
04/07/2017,DEB,AMAZON.CO.UK,16.99,,13079
04/07/2017,BP,SAVE THE CHANGE,0.76,,13095.99
03/07/2017,FEE,ACCOUNT FEE,9.95,,13096.75
03/07/2017,DEB,Amazon UK Marketpl,20.24,,13106.7
03/07/2017,DD,NATWEST BANK,828.49,,13126.94
03/07/2017,DD,CC SWANSEA C.TAX,174,,13955.43
03/07/2017,DD,GOOD ENERGY LTD,85,,14129.43
03/07/2017,DD,ASSURANT INTER LTD,39.74,,14214.43
03/07/2017,DD,DWR CYMRU W WATER,32.5,,14254.17
03/07/2017,DD,TV LICENCE MBP,12.37,,14286.67
03/07/2017,SO,ESAVINGS ACCOUNT,300,,14299.04
03/07/2017,BGC,SWANSEA UNIVERSITY,,319.45,14599.04
30/06/2017,DD,UCU B ACCOUNT,22.7,,14279.59
30/06/2017,BP,SAVE THE CHANGE,0.64,,14302.29
30/06/2017,BGC,SWANSEA UNI - PAY,,3138.65,14302.93
29/06/2017,CPT,LNK UNI - UNIVERSI,250,,11164.28
29/06/2017,DEB,POST OFFICE COUNTE,62.99,,11414.28
29/06/2017,DEB,Amazon UK Marketpl,16.99,,11477.27
29/06/2017,DEB,Amazon UK Marketpl,13.8,,11494.26
29/06/2017,DEB,Amazon UK Marketpl,5.58,,11508.06
29/06/2017,FPO,DEZREZ LEGAL LTD,5619.03,,11513.64
29/06/2017,BP,SAVE THE CHANGE,0.86,,17132.67
28/06/2017,DEB,Amazon UK Marketpl,26.15,,17133.53
28/06/2017,DEB,AMAZON UK RETAIL A,6.99,,17159.68
28/06/2017,BP,SAVE THE CHANGE,0.99,,17166.67
27/06/2017,DEB,Amazon UK Marketpl,19.95,,17167.66
27/06/2017,DEB,Amazon UK Retail,7.15,,17187.61
27/06/2017,DEB,Amazon UK Marketpl,3.91,,17194.76
27/06/2017,CPT,LNK UNI - UNIVERSI,50,,17198.67
27/06/2017,BP,SAVE THE CHANGE,0.8,,17248.67
26/06/2017,DEB,JS ONLINE GROCERY,323.2,,17249.47
26/06/2017,DEP,SKETTY SWANSEA,,211.5,17572.67
26/06/2017,BP,SAVE THE CHANGE,0.01,,17361.17
23/06/2017,DEB,Amazon UK Marketpl,12.99,,17361.18
23/06/2017,CPT,LNK UNI - UNIVERSI,20,,17374.17
22/06/2017,DD,CORGI HOMEPLAN CA,19.5,,17394.17
21/06/2017,FPI,MARIANA MILLS,,375,17413.67
21/06/2017,CPT,LNK UNI - UNIVERSI,50,,17038.67
21/06/2017,DD,VIRGIN MEDIA PYMTS,39.58,,17088.67
21/06/2017,BP,SAVE THE CHANGE,0.75,,17128.25
20/06/2017,DEB,Amazon UK Marketpl,15.99,,17129
20/06/2017,DEB,Amazon UK Marketpl,11.26,,17144.99
20/06/2017,BP,SAVE THE CHANGE,2.29,,17156.25
19/06/2017,DEB,Amazon UK Marketpl,80.16,,17158.54
19/06/2017,DEB,Amazon UK Retail,78.97,,17238.7
19/06/2017,DEB,Amazon UK Retail,44.96,,17317.67
19/06/2017,DEB,Amazon UK Marketpl,27.6,,17362.63
19/06/2017,DEB,AMAZON UK RETAIL A,19.98,,17390.23
19/06/2017,DEB,Amazon UK Marketpl,5.04,,17410.21
19/06/2017,DEB,COOL FISH RIDES S,,136.16,17415.25
19/06/2017,BP,SAVE THE CHANGE,0.94,,17279.09
16/06/2017,DEB,COOL FISH RIDES S,138.52,,17280.03
16/06/2017,DEB,COOL FISH RIDES S,5.54,,17418.55
16/06/2017,DD,O2,20.79,,17424.09
13/06/2017,DEB,FOREIGN CASH FEE,2,,17444.88
13/06/2017,DEB,101823784,92.25,,17446.88
13/06/2017,BP,SAVE THE CHANGE,1.11,,17539.13
12/06/2017,DEB,ARRIVA TRAINS WALE,8.2,,17540.24
12/06/2017,DEB,Amazon UK Retail,9.69,,17548.44
12/06/2017,BP,SAVE THE CHANGE,0.49,,17558.13
12/06/2017,CPT,LNK ARRIVA TRAINS,60,,17558.62
09/06/2017,CPT,LNK UNI - UNIVERSI,50,,17618.62
09/06/2017,DEB,Amazon UK Marketpl,9.51,,17668.62
09/06/2017,DD,LV LIFE,37.12,,17678.13
09/06/2017,BP,SAVE THE CHANGE,0.1,,17715.25
08/06/2017,DEB,WWW.DEZREZLEGAL.CO,245,,17715.35
08/06/2017,DEB,WATSON & PRATTS,128.9,,17960.35
07/06/2017,BP,SAVE THE CHANGE,0.84,,18089.25
06/06/2017,DEB,Amazon UK Marketpl,8.16,,18090.09
06/06/2017,CPT,LNK UNI - UNIVERSI,100,,18098.25
06/06/2017,BP,SAVE THE CHANGE,1.61,,18198.25
05/06/2017,DEB,Amazon UK Marketpl,6.44,,18199.86
05/06/2017,DEB,Amazon UK Marketpl,12.44,,18206.3
05/06/2017,DEB,Amazon Svcs Europe,8.52,,18218.74
05/06/2017,DEB,AMAZON.CO.UK,6.99,,18227.26
05/06/2017,DD,ASSURANT INTER LTD,39.74,,18234.25
05/06/2017,BP,SAVE THE CHANGE,0.55,,18273.99
02/06/2017,DEB,AMAZON.CO.UK,18.45,,18274.54
02/06/2017,CPT,LNK UNI - UNIVERSI,40,,18292.99
01/06/2017,FEE,ACCOUNT FEE,9.95,,18332.99
01/06/2017,CPT,LNK UNI - UNIVERSI,50,,18342.94
01/06/2017,DD,NATWEST BANK,828.49,,18392.94
01/06/2017,DD,CC SWANSEA C.TAX,174,,19221.43
01/06/2017,DD,GOOD ENERGY LTD,85,,19395.43
01/06/2017,DD,DWR CYMRU W WATER,32.5,,19480.43
01/06/2017,DD,TV LICENCE MBP,12.37,,19512.93
01/06/2017,SO,ESAVINGS ACCOUNT,300,,19525.3
31/05/2017,DD,UCU B ACCOUNT,22.7,,19825.3
31/05/2017,BP,SAVE THE CHANGE,0.4,,19848
31/05/2017,BGC,SWANSEA UNI - PAY,,3138.65,19848.4
30/05/2017,DEB,ARRIVA TRAINS WALE,166.6,,16709.75
30/05/2017,BP,SAVE THE CHANGE,0.51,,16876.35
30/05/2017,CPT,LNK RAIL BRISTOL T,50,,16876.86
26/05/2017,DEB,Amazon UK Retail,9.99,,16926.86
26/05/2017,DEB,AMAZON UK RETAIL A,12.5,,16936.85
26/05/2017,CPT,LNK UNI - UNIVERSI,80,,16949.35
26/05/2017,BP,SAVE THE CHANGE,1.49,,17029.35
25/05/2017,CPT,LNK UPLANDS CRESCE,100,,17030.84
25/05/2017,DEB,AMAZON UK RETAIL A,8.16,,17130.84
25/05/2017,DEB,Amazon UK Marketpl,2.35,,17139
25/05/2017,BP,SAVE THE CHANGE,0.12,,17141.35
24/05/2017,DEB,Amazon UK Marketpl,6.96,,17141.47
24/05/2017,DEB,AMAZON UK RETAIL A,10.92,,17148.43
24/05/2017,BP,SAVE THE CHANGE,1.45,,17159.35
23/05/2017,DEB,Amazon UK Marketpl,16.06,,17160.8
23/05/2017,DEB,AMAZON UK RETAIL A,10.49,,17176.86
23/05/2017,CPT,LNK UNI - UNIVERSI,60,,17187.35
23/05/2017,BP,SAVE THE CHANGE,0.01,,17247.35
22/05/2017,DEB,Amazon UK Marketpl,6.99,,17247.36
22/05/2017,DD,VIRGIN MEDIA PYMTS,31.48,,17254.35
22/05/2017,DD,CORGI HOMEPLAN CA,19.5,,17285.83
22/05/2017,BP,SAVE THE CHANGE,1.51,,17305.33
19/05/2017,DEB,ARRIVA TRAINS WALE,22.4,,17306.84
19/05/2017,DEB,Amazon UK Retail,5.75,,17329.24
19/05/2017,DEB,AMAZON UK RETAIL A,11.34,,17334.99
19/05/2017,BP,SAVE THE CHANGE,0.71,,17346.33
18/05/2017,DEB,AMAZON.CO.UK,15.29,,17347.04
18/05/2017,CPT,LNK UNI - UNIVERSI,100,,17362.33
17/05/2017,BP,SAVE THE CHANGE,0.02,,17462.33
16/05/2017,DEB,Amazon UK Retail,23.98,,17462.35
16/05/2017,CPT,LNK UNI - UNIVERSI,100,,17486.33
16/05/2017,DD,O2,18.06,,17586.33
16/05/2017,BP,SAVE THE CHANGE,0.01,,17604.39
15/05/2017,DEB,Amazon UK Marketpl,7.99,,17604.4
15/05/2017,DEB,WWW.DEZREZLEGAL.CO,50,,17612.39
15/05/2017,CPT,LNK UNI - UNIVERSI,50,,17662.39
12/05/2017,CPT,LNK UNI - UNIVERSI,30,,17712.39
09/05/2017,CPT,LNK SWANSEA WIND S,50,,17742.39
09/05/2017,DEB,TICKETS08712200260,33,,17792.39
08/05/2017,DEB,PERSIMMON HOMES WE,200,,17825.39
08/05/2017,DD,LV LIFE,37.12,,18025.39
05/05/2017,DEB,WWW.DEZREZLEGAL.CO,25,,18062.51
05/05/2017,CPT,LOYD TALIESIN BUIL,50,,18087.51
03/05/2017,DD,ASSURANT INTER LTD,39.74,,18137.51
03/05/2017,BP,SAVE THE CHANGE,1.13,,18177.25
02/05/2017,FEE,ACCOUNT FEE,9.95,,18178.38
02/05/2017,DEB,GRUPO HOTELES PLAY,607.58,,18188.33
02/05/2017,DEB,SUSU TRADING LTD,37.29,,18795.91
02/05/2017,CPT,LNK UNI - UNIVERSI,50,,18833.2
02/05/2017,DD,NATWEST BANK,828.49,,18883.2
02/05/2017,DD,CC SWANSEA C.TAX,174,,19711.69
02/05/2017,DD,GOOD ENERGY LTD,85,,19885.69
02/05/2017,DD,DWR CYMRU W WATER,32.5,,19970.69
02/05/2017,DD,TV LICENCE MBP,12.12,,20003.19
02/05/2017,SO,ESAVINGS ACCOUNT,300,,20015.31
02/05/2017,BGC,SWANSEA UNIVERSITY,,692.67,20315.31
28/04/2017,CPT,LNK UNI - UNIVERSI,30,,19622.64
28/04/2017,DD,UCU B ACCOUNT,22.7,,19652.64
28/04/2017,BGC,SWANSEA UNI - PAY,,3138.66,19675.34
26/04/2017,BP,SAVE THE CHANGE,0.03,,16536.68
25/04/2017,DEB,Amazon UK Marketpl,15.97,,16536.71
25/04/2017,CPT,LNK UNI - UNIVERSI,40,,16552.68
25/04/2017,DD,CORGI HOMEPLAN CA,19.5,,16592.68
25/04/2017,BP,SAVE THE CHANGE,0.6,,16612.18
24/04/2017,DEB,AMAZON UK RETAIL A,10.81,,16612.78
24/04/2017,DEB,KLM UK  074132,265.59,,16623.59
24/04/2017,DEB,EXPEDIA 7260559230,3,,16889.18
21/04/2017,CPT,LNK UNI - UNIVERSI,30,,16892.18
21/04/2017,DD,VIRGIN MEDIA PYMTS,31.48,,16922.18
21/04/2017,BP,SAVE THE CHANGE,0.01,,16953.66
20/04/2017,DEB,Amazon Svcs Europe,4.99,,16953.67
20/04/2017,BP,SAVE THE CHANGE,0.74,,16958.66
19/04/2017,DEB,Amazon UK Marketpl,37.71,,16959.4
19/04/2017,DEB,Amazon UK Marketpl,5.8,,16997.11
19/04/2017,DEB,Amazon UK Marketpl,5.75,,17002.91
19/04/2017,CPT,LNK LIFESTYLE EXPR,250,,17008.66
19/04/2017,CPT,LNK UNI - UNIVERSI,40,,17258.66
19/04/2017,DD,O2,31.13,,17298.66
19/04/2017,BP,SAVE THE CHANGE,0.77,,17329.79
18/04/2017,DEB,AMAZON UK RETAIL A,3.99,,17330.56
18/04/2017,DEB,Amazon UK Marketpl,3.24,,17334.55
18/04/2017,BGC,SWANSEA UNIVERSITY,,151.28,17337.79
18/04/2017,CPT,LNK SALUBRIOUS PLA,40,,17186.51
13/04/2017,CPT,LNK UNI - UNIVERSI,80,,17226.51
13/04/2017,BP,SAVE THE CHANGE,0.45,,17306.51
12/04/2017,DEB,Amazon UK Marketpl,13.93,,17306.96
12/04/2017,DEB,Amazon UK Marketpl,6.62,,17320.89
12/04/2017,BP,SAVE THE CHANGE,0.91,,17327.51
11/04/2017,DEB,Amazon UK Marketpl,11.09,,17328.42
11/04/2017,BP,SAVE THE CHANGE,0.67,,17339.51
10/04/2017,DEB,JS ONLINE GROCERY,315.35,,17340.18
10/04/2017,DEB,Amazon UK Marketpl,10.98,,17655.53
10/04/2017,DD,LV LIFE,37.12,,17666.51
07/04/2017,CPT,LNK UNI - UNIVERSI,40,,17703.63
07/04/2017,BP,SAVE THE CHANGE,0.75,,17743.63
06/04/2017,DEB,WATSON & PRATTS,138.25,,17744.38
05/04/2017,CPT,LNK UNI - UNIVERSI,50,,17882.63
05/04/2017,BP,SAVE THE CHANGE,0.04,,17932.63
04/04/2017,DEB,AMAZON UK RETAIL A,104.98,,17932.67
04/04/2017,DEB,Amazon UK Marketpl,17.98,,18037.65
04/04/2017,BP,SAVE THE CHANGE,0.12,,18055.63
03/04/2017,FEE,ACCOUNT FEE,9.95,,18055.75
03/04/2017,DEB,Amazon UK Marketpl,15.99,,18065.7
03/04/2017,DEB,Amazon UK Marketpl,9.99,,18081.69
03/04/2017,DEB,AMAZON UK RETAIL A,35.9,,18091.68
03/04/2017,DD,NATWEST BANK,828.49,,18127.58
03/04/2017,DD,CC SWANSEA C.TAX,177.49,,18956.07
03/04/2017,DD,GOOD ENERGY LTD,85,,19133.56
03/04/2017,DD,ASSURANT INTER LTD,39.74,,19218.56
03/04/2017,DD,DWR CYMRU W WATER,32.5,,19258.3
03/04/2017,DD,TV LICENCE MBP,12.12,,19290.8
03/04/2017,SO,ESAVINGS ACCOUNT,300,,19302.92
31/03/2017,DEB,NON-STG CASH FEE,2,,19602.92
31/03/2017,DEB,NON-STG TRANS FEE,2.47,,19604.92
31/03/2017,DEB,TETOUAN MHANNEC,82.74,,19607.39
31/03/2017,DD,UCU B ACCOUNT,22.7,,19690.13
31/03/2017,DEB,NON-STG CASH FEE,2,,19712.83
31/03/2017,DEB,NON-STG TRANS FEE,2.47,,19714.83
31/03/2017,DEB,CASA AEREPORT M,82.69,,19717.3
31/03/2017,BP,SAVE THE CHANGE,0.03,,19799.99
31/03/2017,BGC,SWANSEA UNI - PAY,,3112.59,19800.02
30/03/2017,DEB,Amazon UK Marketpl,1.97,,16687.43
28/03/2017,BP,SAVE THE CHANGE,0.01,,16689.4
27/03/2017,DEB,Amazon UK Marketpl,26.99,,16689.41
27/03/2017,DEB,Amazon UK Marketpl,6,,16716.4
27/03/2017,BP,SAVE THE CHANGE,0.68,,16722.4
24/03/2017,DEB,Amazon UK Retail,9.9,,16723.08
24/03/2017,DEB,AMAZON UK RETAIL A,9.42,,16732.98
24/03/2017,BP,SAVE THE CHANGE,0.3,,16742.4
23/03/2017,CPT,LOYD TALIESIN BUIL,100,,16742.7
23/03/2017,DEB,AMAZON UK RETAIL A,35.7,,16842.7
23/03/2017,BP,SAVE THE CHANGE,0.21,,16878.4
22/03/2017,DEB,Amazon UK Retail,4.79,,16878.61
22/03/2017,CPT,LNK UNI - UNIVERSI,100,,16883.4
22/03/2017,DD,CORGI HOMEPLAN CA,19.5,,16983.4
21/03/2017,CPT,LNK UNI - UNIVERSI,50,,17002.9
21/03/2017,DD,VIRGIN MEDIA PYMTS,31.48,,17052.9
21/03/2017,BP,SAVE THE CHANGE,1.84,,17084.38
20/03/2017,DEB,AMAZON UK RETAIL A,93.73,,17086.22
20/03/2017,DEB,IKEA ONLINE,82.5,,17179.95
20/03/2017,DEB,Amazon UK Retail,8.97,,17262.45
20/03/2017,DEB,GWR WEBSALES,112.7,,17271.42
20/03/2017,DEB,Amazon UK Marketpl,5.26,,17384.12
17/03/2017,DEB,AMZ*MokenEye-UK,,35.99,17389.38
17/03/2017,CPT,LNK UNI - UNIVERSI,30,,17353.39
17/03/2017,BP,SAVE THE CHANGE,0.75,,17383.39
16/03/2017,DEB,AMAZON.CO.UK,7.25,,17384.14
16/03/2017,CPT,LNK UNI - UNIVERSI,50,,17391.39
16/03/2017,DD,O2,16.83,,17441.39
16/03/2017,BP,SAVE THE CHANGE,0.54,,17458.22
15/03/2017,DEB,Amazon UK Marketpl,3.46,,17458.76
15/03/2017,BP,SAVE THE CHANGE,1.94,,17462.22
14/03/2017,DEB,Amazon UK Marketpl,12.86,,17464.16
14/03/2017,DEB,Amazon UK Marketpl,10.05,,17477.02
14/03/2017,DEB,NON-STG PURCH FEE,1,,17487.07
14/03/2017,DEB,NON-STG TRANS FEE,8.67,,17488.07
14/03/2017,DEB,AIRMARO G.B I,290.15,,17496.74
14/03/2017,BP,SAVE THE CHANGE,0.6,,17786.89
13/03/2017,DEB,ARRIVA TRAINS WALE,22.4,,17787.49
13/03/2017,CPT,LNK ARRIVA TRAINS,80,,17809.89
10/03/2017,DEB,AMAZON UK PRIME AM,79,,17889.89
10/03/2017,CPT,LNK UNI - UNIVERSI,60,,17968.89
10/03/2017,BP,SAVE THE CHANGE,0.97,,18028.89
09/03/2017,DEB,Amazon UK Marketpl,20.03,,18029.86
09/03/2017,BP,SAVE THE CHANGE,0.17,,18049.89
08/03/2017,DEB,AMAZON UK RETAIL A,5.83,,18050.06
08/03/2017,CPT,LNK UNI - UNIVERSI,30,,18055.89
08/03/2017,DD,LV LIFE,37.12,,18085.89
07/03/2017,BP,SAVE THE CHANGE,2.05,,18123.01
06/03/2017,DEB,Amazon UK Marketpl,35.99,,18125.06
06/03/2017,DEB,ARRIVA TRAINS WALE,95.3,,18161.05
06/03/2017,DEB,ASHA'S,42.2,,18256.35
06/03/2017,DEB,Amazon UK Marketpl,10.88,,18298.55
06/03/2017,DEB,WASABI BIRMINGHAM,10.58,,18309.43
06/03/2017,CPT,LNK UNI - UNIVERSI,50,,18320.01
06/03/2017,BP,SAVE THE CHANGE,0.75,,18370.01
03/03/2017,DEB,Amazon UK Marketpl,20.79,,18370.76
03/03/2017,DEB,Amazon UK Marketpl,5.46,,18391.55
03/03/2017,DD,ASSURANT INTER LTD,39.74,,18397.01
02/03/2017,CPT,LNK UNI - UNIVERSI,50,,18436.75
02/03/2017,BP,SAVE THE CHANGE,0.63,,18486.75
01/03/2017,FEE,ACCOUNT FEE,9.95,,18487.38
01/03/2017,DEB,Amazon UK Marketpl,8.38,,18497.33
01/03/2017,DEB,AMAZON UK RETAIL A,3.99,,18505.71
01/03/2017,DD,NATWEST BANK,828.49,,18509.7
01/03/2017,DD,GOOD ENERGY LTD,85,,19338.19
01/03/2017,DD,DWR CYMRU W WATER,32.5,,19423.19
01/03/2017,DD,TV LICENCE MBP,12.12,,19455.69
01/03/2017,SO,ESAVINGS ACCOUNT,300,,19467.81
28/02/2017,CPT,LNK UNI - UNIVERSI,50,,19767.81
28/02/2017,DD,UCU B ACCOUNT,22.7,,19817.81
28/02/2017,BP,SAVE THE CHANGE,0.98,,19840.51
28/02/2017,BGC,SWANSEA UNI - PAY,,3112.59,19841.49
27/02/2017,DEB,AMAZON UK RETAIL A,26.02,,16728.9
24/02/2017,CPT,LNK UNI - UNIVERSI,50,,16754.92
23/02/2017,BP,SAVE THE CHANGE,0.54,,16804.92
22/02/2017,DEB,Amazon UK Marketpl,26.46,,16805.46
22/02/2017,DD,CORGI HOMEPLAN CA,19.5,,16831.92
22/02/2017,BP,SAVE THE CHANGE,0.38,,16851.42
21/02/2017,DEB,Amazon UK Marketpl,3.63,,16851.8
21/02/2017,DEB,AMAZON UK RETAIL A,9.99,,16855.43
21/02/2017,CPT,LNK UNI - UNIVERSI,50,,16865.42
21/02/2017,DD,VIRGIN MEDIA PYMTS,31.48,,16915.42
21/02/2017,BP,SAVE THE CHANGE,0.02,,16946.9
20/02/2017,DEB,Amazon UK Marketpl,7.98,,16946.92
17/02/2017,CPT,LNK UNI - UNIVERSI,40,,16954.9
17/02/2017,CHQ,51,156,,16994.9
17/02/2017,BP,SAVE THE CHANGE,0.94,,17150.9
16/02/2017,DEB,Amazon UK Marketpl,7.82,,17151.84
16/02/2017,DEB,Amazon UK Marketpl,3.24,,17159.66
16/02/2017,DD,O2,16.83,,17162.9
15/02/2017,CPT,LNK UNI - UNIVERSI,40,,17179.73
13/02/2017,CPT,LNK UNI - UNIVERSI,50,,17219.73
13/02/2017,BP,SAVE THE CHANGE,1.35,,17269.73
10/02/2017,DEB,WWW.ORGANICFRESHFO,122.58,,17271.08
10/02/2017,DEB,Amazon UK Marketpl,12.07,,17393.66
10/02/2017,CPT,LNK UNI - UNIVERSI,30,,17405.73
10/02/2017,BP,SAVE THE CHANGE,0.45,,17435.73
09/02/2017,DEB,Amazon UK Marketpl,8.55,,17436.18
08/02/2017,CPT,LNK UNI - UNIVERSI,40,,17444.73
08/02/2017,DD,LV LIFE,37.12,,17484.73
07/02/2017,CPT,LNK UNI - UNIVERSI,50,,17521.85
07/02/2017,BP,SAVE THE CHANGE,0.59,,17571.85
06/02/2017,DEB,Amazon UK Marketpl,4.41,,17572.44
06/02/2017,DEB,Amazon UK Marketpl,6,,17576.85
03/02/2017,CPT,LNK UNI - UNIVERSI,30,,17582.85
03/02/2017,DD,GOOD ENERGY LTD,85,,17612.85
03/02/2017,DD,ASSURANT INTER LTD,39.74,,17697.85
03/02/2017,BP,SAVE THE CHANGE,0.49,,17737.59
02/02/2017,DEB,Amazon UK Marketpl,17.99,,17738.08
02/02/2017,DEB,Amazon UK Marketpl,16.52,,17756.07
02/02/2017,CPT,LNK UNI - UNIVERSI,50,,17772.59
01/02/2017,FEE,ACCOUNT FEE,9.95,,17822.59
01/02/2017,DD,NATWEST BANK,828.49,,17832.54
01/02/2017,DD,DWR CYMRU W WATER,32.5,,18661.03
01/02/2017,DD,TV LICENCE MBP,12.12,,18693.53
01/02/2017,SO,ESAVINGS ACCOUNT,300,,18705.65
01/02/2017,BP,SAVE THE CHANGE,0.01,,19005.65
31/01/2017,DEB,Amazon UK Marketpl,4.99,,19005.66
31/01/2017,CPT,LNK UNI - UNIVERSI,50,,19010.65
31/01/2017,DD,UCU B ACCOUNT,22.7,,19060.65
31/01/2017,BP,SAVE THE CHANGE,0.73,,19083.35
31/01/2017,BGC,SWANSEA UNI - PAY,,3113,19084.08
30/01/2017,DEB,Amazon UK Marketpl,1.27,,15971.08
30/01/2017,BP,SAVE THE CHANGE,2.02,,15972.35
27/01/2017,DEB,JS ONLINE GROCERY,210.85,,15974.37
27/01/2017,DEB,Amazon UK Marketpl,20.03,,16185.22
27/01/2017,DEB,Amazon UK Marketpl,5.4,,16205.25
27/01/2017,DEB,Amazon UK Retail,2.7,,16210.65
27/01/2017,CPT,LNK THE KINGSWAY,60,,16213.35
27/01/2017,BGC,SWANSEA UNIVERSITY,,168.35,16273.35
25/01/2017,FPO,JOHN DEMISA,81,,16105
25/01/2017,CPT,LNK UNI - UNIVERSI,50,,16186
25/01/2017,BP,SAVE THE CHANGE,0.05,,16236
24/01/2017,DEB,TICKETS 0871220026,174,,16236.05
24/01/2017,DEB,Amazon UK Marketpl,15.95,,16410.05
24/01/2017,BP,SAVE THE CHANGE,0.73,,16426
23/01/2017,DEB,ODEON,20,,16426.73
23/01/2017,DEB,Amazon UK Marketpl,1.27,,16446.73
23/01/2017,CPT,LNK UNI - UNIVERSI,60,,16448
23/01/2017,DD,VIRGIN MEDIA PYMTS,31.48,,16508
23/01/2017,DD,CORGI HOMEPLAN CA,19.5,,16539.48
20/01/2017,CPT,LNK UNI - UNIVERSI,60,,16558.98
17/01/2017,CPT,LNK UNI - UNIVERSI,60,,16618.98
17/01/2017,BP,SAVE THE CHANGE,0.01,,16678.98
16/01/2017,DEB,Amazon UK Marketpl,11.99,,16678.99
16/01/2017,DD,O2,18.82,,16690.98
13/01/2017,CPT,LNK UNI - UNIVERSI,50,,16709.8
13/01/2017,BP,SAVE THE CHANGE,0.93,,16759.8
12/01/2017,DEB,Amazon UK Marketpl,12.07,,16760.73
11/01/2017,BP,SAVE THE CHANGE,0.22,,16772.8
10/01/2017,DEB,Amazon UK Marketpl,23.78,,16773.02
10/01/2017,CPT,LNK UNI - UNIVERSI,50,,16796.8
09/01/2017,CPT,LNK UNI - UNIVERSI,30,,16846.8
09/01/2017,DD,LV LIFE,37.12,,16876.8
06/01/2017,CPT,LNK UNI - UNIVERSI,50,,16913.92
06/01/2017,BP,SAVE THE CHANGE,0.58,,16963.92
05/01/2017,DEB,WWW.ORGANICFRESHFO,112.42,,16964.5
05/01/2017,DEB,AMAZON UK RETAIL A,12,,17076.92
05/01/2017,BP,SAVE THE CHANGE,0.69,,17088.92
04/01/2017,DEB,Amazon UK Marketpl,10.58,,17089.61
04/01/2017,DEB,Amazon UK Marketpl,1.73,,17100.19
04/01/2017,BP,SAVE THE CHANGE,1.42,,17101.92
03/01/2017,FEE,ACCOUNT FEE,9.95,,17103.34
03/01/2017,DEB,VUE BSL LTD,24.48,,17113.29
03/01/2017,DEB,AMAZON UK RETAIL A,8.1,,17137.77
03/01/2017,DD,NATWEST BANK,828.49,,17145.87
03/01/2017,DD,CC SWANSEA C.TAX,233,,17974.36
03/01/2017,DD,GOOD ENERGY GAS,43,,18207.36
03/01/2017,DD,GOOD ENERGY LTD,42,,18250.36
03/01/2017,DD,ASSURANT INTER LTD,39.74,,18292.36
03/01/2017,DD,DWR CYMRU W WATER,32.5,,18332.1
03/01/2017,DD,TV LICENCE MBP,12.12,,18364.6
03/01/2017,SO,ESAVINGS ACCOUNT,300,,18376.72
03/01/2017,CPT,LNK SWANSEA WIND S,50,,18676.72
30/12/2016,DD,UCU B ACCOUNT,22.7,,18726.72
29/12/2016,BP,SAVE THE CHANGE,0.05,,18749.42
28/12/2016,DEB,Amazon UK Marketpl,139.95,,18749.47
28/12/2016,FPI,MARIANA MILLS,,250,18889.42
22/12/2016,DD,CORGI HOMEPLAN CA,19.5,,18639.42
22/12/2016,BP,SAVE THE CHANGE,0.4,,18658.92
22/12/2016,BGC,SWANSEA UNIVERSITY,,1048.42,18659.32
21/12/2016,DEB,ARRIVA TRAINS WALE,72.6,,17610.9
21/12/2016,DD,VIRGIN MEDIA PYMTS,31.48,,17683.5
21/12/2016,BP,SAVE THE CHANGE,1.18,,17714.98
20/12/2016,DEB,POST OFFICE COUNTE,4.84,,17716.16
20/12/2016,DEB,Amazon UK Marketpl,4.29,,17721
20/12/2016,DEB,Amazon UK Marketpl,2.69,,17725.29
20/12/2016,BP,SAVE THE CHANGE,0.54,,17727.98
19/12/2016,DEB,Amazon UK Marketpl,26.46,,17728.52
19/12/2016,CPT,LNK UNI - UNIVERSI,100,,17754.98
19/12/2016,BP,SAVE THE CHANGE,0.28,,17854.98
19/12/2016,BGC,SWANSEA UNI - PAY,,3112.59,17855.26
16/12/2016,DEB,AMAZON UK RETAIL A,9.72,,14742.67
16/12/2016,CPT,LNK UNI - UNIVERSI,50,,14752.39
16/12/2016,DD,O2,17.41,,14802.39
16/12/2016,BP,SAVE THE CHANGE,0.85,,14819.8
15/12/2016,DEB,Amazon UK Marketpl,16.15,,14820.65
14/12/2016,BP,SAVE THE CHANGE,0.37,,14836.8
13/12/2016,DEB,Amazon UK Marketpl,3.63,,14837.17
13/12/2016,FPI,MARIANA MILLS,,300,14840.8
13/12/2016,CPT,LNK UNI - UNIVERSI,50,,14540.8
13/12/2016,BP,SAVE THE CHANGE,0.87,,14590.8
12/12/2016,DEB,Amazon UK Retail,13.79,,14591.67
12/12/2016,DEB,Amazon UK Marketpl,3.45,,14605.46
12/12/2016,DEB,AMAZON UK RETAIL A,9.99,,14608.91
12/12/2016,DEB,Amazon UK Retail,9.9,,14618.9
09/12/2016,CPT,LOYD TALIESIN BUIL,50,,14628.8
09/12/2016,DD,LV LIFE,37.12,,14678.8
09/12/2016,BP,SAVE THE CHANGE,0.97,,14715.92
08/12/2016,DEB,Amazon UK Marketpl,20.03,,14716.89
08/12/2016,DEB,AMAZON UK RETAIL A,,7,14736.92
07/12/2016,CPT,LNK UNI - UNIVERSI,40,,14729.92
07/12/2016,BP,SAVE THE CHANGE,1.39,,14769.92
06/12/2016,DEB,AMAZON UK RETAIL A,88.9,,14771.31
06/12/2016,DEB,AMAZON MKTPLACE PM,29.34,,14860.21
06/12/2016,DEB,AMAZON.DE PAYMENTS,16.56,,14889.55
06/12/2016,DEB,AMAZON MKTPLACE PM,7.81,,14906.11
06/12/2016,CPT,LNK UNI - UNIVERSI,40,,14913.92
05/12/2016,DD,ASSURANT INTER LTD,39.74,,14953.92
05/12/2016,BP,SAVE THE CHANGE,0.56,,14993.66
02/12/2016,DEB,Amazon *Mktplce EU,96.95,,14994.22
02/12/2016,DEB,Amazon UK Marketpl,18.49,,15091.17
02/12/2016,CPT,LNK UNI - UNIVERSI,50,,15109.66
01/12/2016,FEE,ACCOUNT FEE,9.95,,15159.66
01/12/2016,DD,NATWEST BANK,828.49,,15169.61
01/12/2016,DD,CC SWANSEA C.TAX,233,,15998.1
01/12/2016,DD,GOOD ENERGY GAS,43,,16231.1
01/12/2016,DD,GOOD ENERGY LTD,42,,16274.1
01/12/2016,DD,DWR CYMRU W WATER,32.5,,16316.1
01/12/2016,DD,TV LICENCE MBP,12.18,,16348.6
01/12/2016,SO,ESAVINGS ACCOUNT,300,,16360.78
01/12/2016,BP,SAVE THE CHANGE,0.6,,16660.78
30/11/2016,DEB,ARRIVA TRAINS WALE,56.4,,16661.38
30/11/2016,DD,UCU B ACCOUNT,22.7,,16717.78
30/11/2016,BP,SAVE THE CHANGE,0.6,,16740.48
30/11/2016,BGC,SWANSEA UNI - PAY,,3112.59,16741.08
29/11/2016,CPT,LNK ARRIVA TRAINS,80,,13628.49
29/11/2016,DEB,ARRIVA TRAINS WALE,56.4,,13708.49
29/11/2016,BP,SAVE THE CHANGE,0.1,,13764.89
28/11/2016,DEB,Amazon UK Marketpl,12.9,,13764.99
28/11/2016,CPT,LNK ARRIVA TRAINS,80,,13777.89
28/11/2016,BP,SAVE THE CHANGE,0.35,,13857.89
28/11/2016,FPI,MARIANA MILLS,,25,13858.24
25/11/2016,DEB,JS ONLINE GROCERY,322.65,,13833.24
25/11/2016,CPT,LNK UNI - UNIVERSI,50,,14155.89
24/11/2016,BP,SAVE THE CHANGE,0.02,,14205.89
23/11/2016,DEB,Amazon UK Marketpl,39.99,,14205.91
23/11/2016,DEB,AMAZON UK RETAIL A,10.99,,14245.9
23/11/2016,CPT,LNK UNI - UNIVERSI,50,,14256.89
23/11/2016,BP,SAVE THE CHANGE,1.58,,14306.89
22/11/2016,DEB,Amazon UK Marketpl,408.45,,14308.47
22/11/2016,DEB,Amazon UK Marketpl,9.49,,14716.92
22/11/2016,DEB,SUSU TRADING LTD,54.48,,14726.41
22/11/2016,DD,CORGI HOMEPLAN CA,19.5,,14780.89
22/11/2016,BP,SAVE THE CHANGE,0.86,,14800.39
21/11/2016,DEB,Amazon UK Marketpl,42.98,,14801.25
21/11/2016,DEB,Amazon UK Marketpl,23.99,,14844.23
21/11/2016,DEB,Amazon UK Marketpl,8.17,,14868.22
21/11/2016,CPT,LNK UNI - UNIVERSI,50,,14876.39
21/11/2016,DD,VIRGIN MEDIA PYMTS,31.48,,14926.39
21/11/2016,BP,SAVE THE CHANGE,0.05,,14957.87
18/11/2016,DEB,Amazon UK Marketpl,10.95,,14957.92
16/11/2016,DD,O2,37.28,,14968.87
16/11/2016,BP,SAVE THE CHANGE,1.52,,15006.15
15/11/2016,DEB,Amazon UK Marketpl,12.49,,15007.67
15/11/2016,DEB,Amazon Svcs Europe,8.5,,15020.16
15/11/2016,DEB,Amazon UK Marketpl,8.49,,15028.66
15/11/2016,CPT,LNK UNI - UNIVERSI,50,,15037.15
15/11/2016,BP,SAVE THE CHANGE,0.01,,15087.15
14/11/2016,DEB,WWW.ALLBAMBOOLTD.C,102,,15087.16
14/11/2016,DEB,Amazon UK Retail,5.99,,15189.16
14/11/2016,FPI,MARIANA MILLS 13NOV16,,130,15195.15
11/11/2016,CPT,LOYD TALIESIN BUIL,50,,15065.15
11/11/2016,CHQ,47,320,,15115.15
09/11/2016,DD,LV LIFE,37.12,,15435.15
09/11/2016,BP,SAVE THE CHANGE,1.04,,15472.27
08/11/2016,DEB,Amazon UK Retail,11.45,,15473.31
08/11/2016,DEB,AMAZON MKTPLACE PM,6.51,,15484.76
08/11/2016,CPT,LNK FULTON HOUSE,50,,15491.27
08/11/2016,BP,SAVE THE CHANGE,0.96,,15541.27
07/11/2016,DEB,Amazon Svcs Europe,14.04,,15542.23
07/11/2016,BP,SAVE THE CHANGE,0.8,,15556.27
04/11/2016,DEB,SWANSEA UNI - CATE,4.2,,15557.07
04/11/2016,CPT,LOYD WALES UNIV SW,20,,15561.27
03/11/2016,CPT,LOYD WALES UNIV SW,50,,15581.27
03/11/2016,DD,ASSURANT INTER LTD,39.74,,15631.27
03/11/2016,BP,SAVE THE CHANGE,0.44,,15671.01
02/11/2016,DEB,Amazon UK Marketpl,27.56,,15671.45
02/11/2016,BP,SAVE THE CHANGE,0.78,,15699.01
01/11/2016,FEE,ACCOUNT FEE,9.95,,15699.79
01/11/2016,FPI,MARIANA MILLS,,250,15709.74
01/11/2016,DD,NATWEST BANK,828.49,,15459.74
01/11/2016,DD,CC SWANSEA C.TAX,233,,16288.23
01/11/2016,DD,GOOD ENERGY GAS,43,,16521.23
01/11/2016,DD,GOOD ENERGY LTD,42,,16564.23
01/11/2016,DD,DWR CYMRU W WATER,32.5,,16606.23
01/11/2016,DD,TV LICENCE MBP,12.12,,16638.73
01/11/2016,DEB,NON-STG PURCH FEE,1,,16650.85
01/11/2016,DEB,NON-STG TRANS FEE,24.49,,16651.85
01/11/2016,DEB,EMBASSY SUITES BAL,819.22,,16676.34
01/11/2016,SO,ESAVINGS ACCOUNT,300,,17495.56
31/10/2016,CPT,LOYD WALES UNIV SW,50,,17795.56
31/10/2016,DD,UCU B ACCOUNT,22.7,,17845.56
31/10/2016,BGC,SWANSEA UNI - PAY,,3166.96,17868.26
28/10/2016,BP,SAVE THE CHANGE,0.06,,14701.3
28/10/2016,BGC,SWANSEA UNIVERSITY,,438.85,14701.36
27/10/2016,DEB,NON-STG PURCH FEE,1,,14262.51
27/10/2016,DEB,NON-STG TRANS FEE,2.45,,14263.51
27/10/2016,DEB,SUPREME AIRPORT SH,81.94,,14265.96
25/10/2016,BP,SAVE THE CHANGE,0.43,,14347.9
24/10/2016,DEB,Amazon UK Marketpl,13.57,,14348.33
24/10/2016,DD,CORGI HOMEPLAN CA,19.5,,14361.9
24/10/2016,BP,SAVE THE CHANGE,0.04,,14381.4
24/10/2016,BGC,SWANSEA UNIVERSITY,,335.33,14381.44
21/10/2016,DEB,EASYJET   ERB813,645.96,,14046.11
21/10/2016,CPT,LOYD WALES UNIV SW,70,,14692.07
21/10/2016,DD,VIRGIN MEDIA PYMTS,27.99,,14762.07
21/10/2016,BP,SAVE THE CHANGE,0.02,,14790.06
20/10/2016,FPI,MARIANA MILLS,,340,14790.08
20/10/2016,DEB,Amazon UK Marketpl,10.98,,14450.08
20/10/2016,CPT,LOYD WALES UNIV SW,80,,14461.06
20/10/2016,BP,SAVE THE CHANGE,0.94,,14541.06
19/10/2016,DEB,SUSU TRADING LTD,52.84,,14542
19/10/2016,DEB,Amazon *Mktplce EU,11.22,,14594.84
18/10/2016,BP,SAVE THE CHANGE,0.97,,14606.06
17/10/2016,DEB,Amazon UK Retail,30.43,,14607.03
17/10/2016,DEB,Audible.co.uk,14.6,,14637.46
17/10/2016,DEB,EC GIFTWARE LTD,,6.65,14652.06
17/10/2016,DD,O2,33.12,,14645.41
17/10/2016,BP,SAVE THE CHANGE,1.99,,14678.53
14/10/2016,DEB,Amazon UK Marketpl,14.01,,14680.52
14/10/2016,DEB,Amazon UK Marketpl,11.49,,14694.53
14/10/2016,DEB,EC GIFTWARE LTD,72.51,,14706.02
14/10/2016,CPT,LOYD WALES UNIV SW,40,,14778.53
11/10/2016,BP,SAVE THE CHANGE,1.07,,14818.53
10/10/2016,DEB,Amazon UK Marketpl,22.99,,14819.6
10/10/2016,DEB,Amazon UK Marketpl,29.44,,14842.59
10/10/2016,DEB,Amazon UK Marketpl,8.5,,14872.03
10/10/2016,CPT,LOYD WALES UNIV SW,30,,14880.53
10/10/2016,DD,LV LIFE,37.12,,14910.53
10/10/2016,BP,SAVE THE CHANGE,1.05,,14947.65
07/10/2016,DEB,AMAZON UK RETAIL A,10.19,,14948.7
07/10/2016,DEB,Amazon Svcs Europe,8.76,,14958.89
07/10/2016,CPT,LOYD WALES UNIV SW,20,,14967.65
07/10/2016,CHQ,46,40,,14987.65
06/10/2016,FPI,MARIANA MILLS,,250,15027.65
06/10/2016,CPT,LOYD WALES UNIV SW,40,,14777.65
05/10/2016,BP,SAVE THE CHANGE,0.83,,14817.65
04/10/2016,DEB,Amazon UK Marketpl,9.98,,14818.48
04/10/2016,DEB,Amazon UK Marketpl,9.94,,14828.46
04/10/2016,DEB,Amazon UK Marketpl,4.25,,14838.4
04/10/2016,BP,SAVE THE CHANGE,0.47,,14842.65
03/10/2016,FEE,ACCOUNT FEE,9.95,,14843.12
03/10/2016,DEB,Amazon UK Marketpl,38.53,,14853.07
03/10/2016,DEB,Amazon UK Marketpl,165,,14891.6
03/10/2016,DD,NATWEST BANK,828.49,,15056.6
03/10/2016,DD,CC SWANSEA C.TAX,231.81,,15885.09
03/10/2016,DD,GOOD ENERGY GAS,43,,16116.9
03/10/2016,DD,GOOD ENERGY LTD,42,,16159.9
03/10/2016,DD,ASSURANT INTER LTD,39.74,,16201.9
03/10/2016,DD,DWR CYMRU W WATER,29.5,,16241.64
03/10/2016,DD,TV LICENCE MBP,12.12,,16271.14
03/10/2016,SO,ESAVINGS ACCOUNT,300,,16283.26
03/10/2016,BP,SAVE THE CHANGE,0.85,,16583.26
30/09/2016,DEB,JS ONLINE GROCERY,194.15,,16584.11
30/09/2016,DEB,JS ONLINE GROCERY,,3,16778.26
30/09/2016,CPT,LOYD WALES UNIV SW,30,,16775.26
30/09/2016,DD,UCU B ACCOUNT,22.7,,16805.26
30/09/2016,BGC,SWANSEA UNI - PAY,,3085.63,16827.96
29/09/2016,BP,SAVE THE CHANGE,1.69,,13742.33
28/09/2016,DEB,Amazon UK Marketpl,22.99,,13744.02
28/09/2016,DEB,PIZZA EXPRESS,20.3,,13767.01
28/09/2016,DEB,Amazon Svcs Europe,7.02,,13787.31
28/09/2016,CPT,LOYD WALES UNIV SW,50,,13794.33
28/09/2016,BP,SAVE THE CHANGE,1.39,,13844.33
27/09/2016,DEB,HILTON,265,,13845.72
27/09/2016,DEB,ARRIVA TRAINS WALE,116.8,,14110.72
27/09/2016,DEB,ARRIVA TRAINS WALE,113.8,,14227.52
27/09/2016,DEB,Amazon UK Marketpl,13.54,,14341.32
27/09/2016,DEB,SKR*ETHICAL PETS,28.47,,14354.86
27/09/2016,DEB,ARRIVA TRAINS WALE,,113.8,14383.33
27/09/2016,BP,SAVE THE CHANGE,1.14,,14269.53
26/09/2016,DEB,Amazon UK Retail,10.74,,14270.67
26/09/2016,DEB,Amazon UK Marketpl,1.83,,14281.41
26/09/2016,DEB,Amazon UK Marketpl,12.29,,14283.24
26/09/2016,CPT,LNK ARRIVA TRAINS,50,,14295.53
23/09/2016,BP,SAVE THE CHANGE,0.53,,14345.53
22/09/2016,DEB,AMAZON UK RETAIL A,159.98,,14346.06
22/09/2016,DEB,AMAZON UK RETAIL A,19.49,,14506.04
22/09/2016,DD,CORGI HOMEPLAN CA,19.5,,14525.53
22/09/2016,BP,SAVE THE CHANGE,0.04,,14545.03
21/09/2016,DEB,AMAZON UK RETAIL A,129.96,,14545.07
21/09/2016,DD,VIRGIN MEDIA PYMTS,27.99,,14675.03
21/09/2016,BP,SAVE THE CHANGE,0.05,,14703.02
20/09/2016,DEB,Amazon UK Marketpl,16.99,,14703.07
20/09/2016,DEB,Amazon UK Marketpl,14.96,,14720.06
16/09/2016,DD,O2,24.21,,14735.02
14/09/2016,BP,SAVE THE CHANGE,0.05,,14759.23
13/09/2016,DEB,Amazon UK Marketpl,36.95,,14759.28
13/09/2016,BP,SAVE THE CHANGE,0.28,,14796.23
12/09/2016,DEB,Amazon UK Marketpl,9.72,,14796.51
12/09/2016,BP,SAVE THE CHANGE,0.42,,14806.23
12/09/2016,FPI,MARIANA MILLS,,150,14806.65
09/09/2016,DEB,Amazon UK Marketpl,37.99,,14656.65
09/09/2016,DEB,Amazon UK Marketpl,9.89,,14694.64
09/09/2016,DEB,AMAZON UK RETAIL A,21.7,,14704.53
09/09/2016,CPT,LOYD WALES UNIV SW,50,,14726.23
09/09/2016,DD,LV LIFE,37.12,,14776.23
09/09/2016,BP,SAVE THE CHANGE,0.61,,14813.35
08/09/2016,DEB,Amazon UK Marketpl,14.95,,14813.96
08/09/2016,DEB,Amazon UK Marketpl,9.9,,14828.91
08/09/2016,DEB,Amazon UK Marketpl,5.54,,14838.81
06/09/2016,BP,SAVE THE CHANGE,0.75,,14844.35
05/09/2016,DEB,NON-STG PURCH FEE,1,,14845.1
05/09/2016,DEB,NON-STG TRANS FEE,1.77,,14846.1
05/09/2016,DEB,TERRA RESTAURANTE,59.25,,14847.87
05/09/2016,DD,ASSURANT INTER LTD,39.85,,14907.12
05/09/2016,BP,SAVE THE CHANGE,0.4,,14946.97
02/09/2016,DEB,ARRIVA TRAINS WALE,72.6,,14947.37
01/09/2016,FEE,ACCOUNT FEE,9.95,,15019.97
01/09/2016,DD,NATWEST BANK,828.49,,15029.92
01/09/2016,DD,CC SWANSEA C.TAX,127,,15858.41
01/09/2016,DD,GOOD ENERGY GAS,43,,15985.41
01/09/2016,DD,GOOD ENERGY LTD,42,,16028.41
01/09/2016,DD,DWR CYMRU W WATER,29.5,,16070.41
01/09/2016,DD,TV LICENCE MBP,12.12,,16099.91
01/09/2016,SO,ESAVINGS ACCOUNT,300,,16112.03
01/09/2016,BP,SAVE THE CHANGE,0.67,,16412.03
31/08/2016,DEB,Amazon UK Marketpl,19.33,,16412.7
31/08/2016,BP,SAVE THE CHANGE,0.47,,16432.03
31/08/2016,BGC,SWANSEA UNI - PAY,,3085.63,16432.5
30/08/2016,DEB,Amazon UK Marketpl,19.99,,13346.87
30/08/2016,DEB,Amazon UK Marketpl,13.96,,13366.86
30/08/2016,DEB,Amazon UK Marketpl,13.58,,13380.82
30/08/2016,CPT,LOYD WALES UNIV SW,30,,13394.4
30/08/2016,BP,SAVE THE CHANGE,0.22,,13424.4
30/08/2016,CPT,LNK UNION STREET,30,,13424.62
26/08/2016,DEB,Amazon UK Marketpl,6.78,,13454.62
26/08/2016,CPT,LOYD WALES UNIV SW,30,,13461.4
26/08/2016,DD,UCU B ACCOUNT,22.37,,13491.4
26/08/2016,BP,SAVE THE CHANGE,1.21,,13513.77
25/08/2016,DEB,Amazon UK Marketpl,5.16,,13514.98
25/08/2016,DEB,AMAZON UK RETAIL A,3.63,,13520.14
25/08/2016,FPO,FB EDMUNDS,31.25,,13523.77
25/08/2016,BP,SAVE THE CHANGE,1.03,,13555.02
24/08/2016,DEB,Amazon UK Marketpl,89.99,,13556.05
24/08/2016,DEB,Amazon UK Marketpl,21.25,,13646.04
24/08/2016,DEB,AMAZON UK RETAIL A,13.73,,13667.29
24/08/2016,DEB,Amazon UK Marketpl,,17.99,13681.02
24/08/2016,CPT,LOYD WALES UNIV SW,50,,13663.03
24/08/2016,BP,SAVE THE CHANGE,0.29,,13713.03
23/08/2016,DEB,Amazon UK Marketpl,9.72,,13713.32
23/08/2016,DEB,Amazon UK Marketpl,8.99,,13723.04
23/08/2016,BP,SAVE THE CHANGE,1.43,,13732.03
22/08/2016,DEB,Amazon UK Marketpl,11.38,,13733.46
22/08/2016,DEB,Amazon UK Retail,58.2,,13744.84
22/08/2016,DEB,Amazon UK Marketpl,49.99,,13803.04
22/08/2016,DD,VIRGIN MEDIA PYMTS,27.99,,13853.03
22/08/2016,DD,CORGI HOMEPLAN CA,19.5,,13881.02
19/08/2016,FPI,MARIANA MILLS,,175,13900.52
17/08/2016,DEB,CROWNE PLAZA,135,,13725.52
17/08/2016,BP,SAVE THE CHANGE,0.2,,13860.52
16/08/2016,DEB,CROWNE PLAZA,25.8,,13860.72
16/08/2016,DD,O2,17.32,,13886.52
16/08/2016,BP,SAVE THE CHANGE,1,,13903.84
15/08/2016,DEB,JS ONLINE GROCERY,368.5,,13904.84
15/08/2016,DEB,Amazon UK Marketpl,17.99,,14273.34
15/08/2016,DEB,GWR WEBSALES ECOM,137,,14291.33
15/08/2016,DEB,AMAZON UK RETAIL A,99.51,,14428.33
15/08/2016,CPT,LNK ARRIVA TRAINS,50,,14527.84
15/08/2016,BP,SAVE THE CHANGE,0.1,,14577.84
12/08/2016,DEB,Amazon UK Marketpl,16.9,,14577.94
12/08/2016,CPT,LOYD WALES UNIV SW,50,,14594.84
09/08/2016,BP,SAVE THE CHANGE,0.19,,14644.84
08/08/2016,DEB,Amazon UK Marketpl,2.81,,14645.03
08/08/2016,DD,LV LIFE,37.12,,14647.84
05/08/2016,BP,SAVE THE CHANGE,1.03,,14684.96
04/08/2016,DEB,Amazon UK Marketpl,13.89,,14685.99
04/08/2016,DEB,NON-STG PURCH FEE,1,,14699.88
04/08/2016,DEB,NON-STG TRANS FEE,0.18,,14700.88
04/08/2016,DEB,KLM NETHERLA074821,6.08,,14701.06
03/08/2016,DD,ASSURANT INTER LTD,35.56,,14707.14
02/08/2016,BP,SAVE THE CHANGE,0.52,,14742.7
02/08/2016,BGC,SWANSEA UNIVERSITY,,1652.84,14743.22
01/08/2016,FEE,ACCOUNT FEE,9.95,,13090.38
01/08/2016,DEB,Amazon UK Marketpl,9.48,,13100.33
01/08/2016,CPT,LOYD WALES UNIV SW,100,,13109.81
01/08/2016,DD,NATWEST BANK,828.49,,13209.81
01/08/2016,DD,CC SWANSEA C.TAX,127,,14038.3
01/08/2016,DD,GOOD ENERGY GAS,43,,14165.3
01/08/2016,DD,DWR CYMRU W WATER,29.5,,14208.3
01/08/2016,DD,GOOD ENERGY LTD,13,,14237.8
01/08/2016,DD,TV LICENCE MBP,12.12,,14250.8
01/08/2016,SO,ESAVINGS ACCOUNT,300,,14262.92
01/08/2016,BP,SAVE THE CHANGE,0.52,,14562.92
29/07/2016,DEB,Amazon UK Marketpl,16.48,,14563.44
29/07/2016,CPT,LOYD WALES UNIV SW,50,,14579.92
29/07/2016,DD,UCU B ACCOUNT,22.37,,14629.92
29/07/2016,BP,SAVE THE CHANGE,0.6,,14652.29
29/07/2016,BGC,SWANSEA UNI - PAY,,3085.64,14652.89
28/07/2016,DEB,Amazon UK Retail,16.74,,11567.25
28/07/2016,DEB,Amazon UK Marketpl,13.98,,11583.99
28/07/2016,DEB,Amazon Svcs Europe,6.68,,11597.97
28/07/2016,BP,SAVE THE CHANGE,1.32,,11604.65
27/07/2016,DEB,Amazon UK Marketpl,14.22,,11605.97
27/07/2016,DEB,Amazon UK Marketpl,10.46,,11620.19
27/07/2016,CPT,LOYD WALES UNIV SW,20,,11630.65
27/07/2016,BP,SAVE THE CHANGE,0.01,,11650.65
26/07/2016,DEB,Amazon UK Marketpl,15.99,,11650.66
25/07/2016,DD,CORGI HOMEPLAN CA,19.5,,11666.65
25/07/2016,BP,SAVE THE CHANGE,1.38,,11686.15
25/07/2016,BGC,UNIVERSITY OF EAST,,167.84,11687.53
22/07/2016,DEB,Amazon UK Marketpl,18.13,,11519.69
22/07/2016,DEB,AMAZON UK RETAIL A,9.49,,11537.82
22/07/2016,CPT,LOYD WALES UNIV SW,50,,11547.31
22/07/2016,BP,SAVE THE CHANGE,0.42,,11597.31
21/07/2016,DEB,Amazon UK Retail,9.9,,11597.73
21/07/2016,DEB,Amazon UK Marketpl,8.68,,11607.63
21/07/2016,DD,VIRGIN MEDIA PYMTS,27.99,,11616.31
21/07/2016,BP,SAVE THE CHANGE,0.02,,11644.3
20/07/2016,DEB,EXPEDIA 1126326416,774.98,,11644.32
20/07/2016,BP,SAVE THE CHANGE,0.77,,12419.3
19/07/2016,DEB,Amazon Svcs Europe,12.23,,12420.07
19/07/2016,BP,SAVE THE CHANGE,0.74,,12432.3
18/07/2016,DEB,EASYJET   EQWFKG,383.96,,12433.04
18/07/2016,DEB,Amazon UK Marketpl,7.3,,12817
18/07/2016,DD,O2,22.81,,12824.3
18/07/2016,BP,SAVE THE CHANGE,0.95,,12847.11
18/07/2016,CPT,SBY  SWANSEA UPL C,50,,12848.06
18/07/2016,DEB,Amazon UK Marketpl,23.05,,12898.06
15/07/2016,CPT,LOYD WALES UNIV SW,50,,12921.11
15/07/2016,BGC,SWANSEA UNIVERSITY,,858.01,12971.11
14/07/2016,BP,SAVE THE CHANGE,1.23,,12113.1
13/07/2016,DEB,Amazon UK Marketpl,32.29,,12114.33
13/07/2016,DEB,Amazon UK Marketpl,17.48,,12146.62
13/07/2016,CPT,LOYD WALES UNIV SW,50,,12164.1
12/07/2016,CPT,LOYD WALES UNIV SW,50,,12214.1
12/07/2016,BP,SAVE THE CHANGE,0.34,,12264.1
11/07/2016,DEB,Amazon UK Marketpl,13.98,,12264.44
11/07/2016,DEB,Amazon UK Marketpl,8.68,,12278.42
08/07/2016,CPT,LOYD WALES UNIV SW,60,,12287.1
08/07/2016,DD,LV LIFE,37.12,,12347.1
07/07/2016,DD,ASSURANT INTER LTD,35.56,,12384.22
07/07/2016,BP,SAVE THE CHANGE,0.71,,12419.78
06/07/2016,FPI,MARIANA MILLS,,300,12420.49
06/07/2016,DEB,NON-STG PURCH FEE,1,,12120.49
06/07/2016,DEB,NON-STG TRANS FEE,28.89,,12121.49
06/07/2016,DEB,ALEXANDER BEACH HO,966.29,,12150.38
06/07/2016,BP,SAVE THE CHANGE,0.06,,13116.67
05/07/2016,CPT,LOYD SWANSEA UNIVE,30,,13116.73
05/07/2016,DEB,Amazon UK Marketpl,39.94,,13146.73
05/07/2016,BP,SAVE THE CHANGE,0.67,,13186.67
04/07/2016,DEB,Amazon UK Retail,21.33,,13187.34
04/07/2016,DEB,SWANSEA UNIVERSITY,1100,,13208.67
04/07/2016,CPT,LNK BRISTOL LANDSI,50,,14308.67
01/07/2016,FEE,ACCOUNT FEE,9.95,,14358.67
01/07/2016,DD,NATWEST BANK,828.49,,14368.62
01/07/2016,DD,CC SWANSEA C.TAX,127,,15197.11
01/07/2016,DD,GOOD ENERGY GAS,43,,15324.11
01/07/2016,DD,DWR CYMRU W WATER,29.5,,15367.11
01/07/2016,DD,GOOD ENERGY LTD,13,,15396.61
01/07/2016,DD,TV LICENCE MBP,12.12,,15409.61
01/07/2016,SO,ESAVINGS ACCOUNT,300,,15421.73
30/06/2016,DD,UCU B ACCOUNT,22.37,,15721.73
30/06/2016,BGC,SWANSEA UNI - PAY,,3085.63,15744.1
28/06/2016,BP,SAVE THE CHANGE,0.4,,12658.47
27/06/2016,DEB,FOREIGN CASH FEE,2.87,,12658.87
27/06/2016,DEB,Stalida-Malia,191.84,,12661.74
27/06/2016,DEB,ARRIVA TRAINS WALE,72.6,,12853.58
27/06/2016,DEB,J B PEARCE LTD,65,,12926.18
24/06/2016,BP,SAVE THE CHANGE,0.51,,12991.18
23/06/2016,DEB,Amazon UK Marketpl,5.49,,12991.69
23/06/2016,DD,CORGI HOMEPLAN CA,19.5,,12997.18
22/06/2016,BP,SAVE THE CHANGE,1.02,,13016.68
21/06/2016,CPT,LNK SWANSEA WIND S,50,,13017.7
21/06/2016,DEB,Amazon UK Retail,22.49,,13067.7
21/06/2016,DEB,Amazon UK Marketpl,15.49,,13090.19
21/06/2016,DD,VIRGIN MEDIA PYMTS,27.99,,13105.68
21/06/2016,BP,SAVE THE CHANGE,0.67,,13133.67
20/06/2016,DEB,Amazon UK Marketpl,11.99,,13134.34
20/06/2016,DEB,Amazon UK Marketpl,4.34,,13146.33
20/06/2016,DEB,SKYPE SUBSCRIPTION,10,,13150.67
17/06/2016,CPT,LOYD WALES UNIV SW,20,,13160.67
17/06/2016,BP,SAVE THE CHANGE,0.94,,13180.67
16/06/2016,DEB,Amazon UK Marketpl,5.06,,13181.61
16/06/2016,DD,O2,16.83,,13186.67
15/06/2016,BP,SAVE THE CHANGE,0.64,,13203.5
14/06/2016,DEB,Amazon UK Marketpl,3.36,,13204.14
14/06/2016,BP,SAVE THE CHANGE,0.43,,13207.5
13/06/2016,DEB,JS ONLINE GROCERY,235.83,,13207.93
13/06/2016,DEB,Amazon UK Marketpl,26.74,,13443.76
08/06/2016,DD,LV LIFE,37.12,,13470.5
08/06/2016,DEB,NON-STG CASH FEE,2,,13507.62
08/06/2016,DEB,NON-STG TRANS FEE,3.54,,13509.62
08/06/2016,DEB,ING BANK,118.56,,13513.16
07/06/2016,BP,SAVE THE CHANGE,1.93,,13631.72
06/06/2016,DEB,SCHIMMELPENNICKHUY,385.66,,13633.65
06/06/2016,DEB,NON-STG PURCH FEE,1,,14019.31
06/06/2016,DEB,NON-STG TRANS FEE,1.25,,14020.31
06/06/2016,DEB,NS SCHIPHOL,42.03,,14021.56
06/06/2016,DEB,Amazon UK Marketpl,9.75,,14063.59
06/06/2016,DEB,Amazon UK Marketpl,3.63,,14073.34
06/06/2016,BP,SAVE THE CHANGE,1.25,,14076.97
03/06/2016,DEB,Amazon UK Marketpl,15.21,,14078.22
03/06/2016,DEB,Amazon UK Marketpl,5.54,,14093.43
03/06/2016,DD,ASSURANT INTER LTD,35.56,,14098.97
03/06/2016,BP,SAVE THE CHANGE,0.65,,14134.53
02/06/2016,DEB,Amazon UK Retail,12.35,,14135.18
02/06/2016,BP,SAVE THE CHANGE,0.81,,14147.53
01/06/2016,FEE,ACCOUNT FEE,9.95,,14148.34
01/06/2016,DEB,Amazon UK Marketpl,4.2,,14158.29
01/06/2016,DEB,Amazon UK Marketpl,3.99,,14162.49
01/06/2016,DD,NATWEST BANK,828.49,,14166.48
01/06/2016,DD,CC SWANSEA C.TAX,127,,14994.97
01/06/2016,DD,GOOD ENERGY GAS,43,,15121.97
01/06/2016,DD,DWR CYMRU W WATER,29.5,,15164.97
01/06/2016,DD,GOOD ENERGY LTD,13,,15194.47
01/06/2016,DD,TV LICENCE MBP,12.12,,15207.47
01/06/2016,SO,ESAVINGS ACCOUNT,300,,15219.59
01/06/2016,BP,SAVE THE CHANGE,0.33,,15519.59
31/05/2016,DEB,EASYJET   000EQP,665.72,,15519.92
31/05/2016,DEB,Amazon UK Marketpl,6.95,,16185.64
31/05/2016,DD,UCU B ACCOUNT,22.37,,16192.59
31/05/2016,BP,SAVE THE CHANGE,0.57,,16214.96
31/05/2016,BGC,SWANSEA UNI - PAY,,3085.63,16215.53
31/05/2016,CPT,LNK SWANSEA 2,50,,13129.9
27/05/2016,DEB,ARRIVA TRAINS WALE,137.7,,13179.9
27/05/2016,DEB,Amazon UK Marketpl,3.73,,13317.6
27/05/2016,BP,SAVE THE CHANGE,0.01,,13321.33
26/05/2016,DEB,Amazon UK Marketpl,17.99,,13321.34
26/05/2016,BP,SAVE THE CHANGE,1.16,,13339.33
25/05/2016,DEB,Amazon UK Marketpl,9.75,,13340.49
25/05/2016,DEB,Amazon UK Marketpl,8.09,,13350.24
25/05/2016,CPT,LOYD WALES UNIV SW,50,,13358.33
25/05/2016,BGC,UNIVERSITY OF OXFO,,340,13408.33
24/05/2016,BP,SAVE THE CHANGE,0.93,,13068.33
23/05/2016,DEB,AMAZON MKTPLACE PM,10.9,,13069.26
23/05/2016,DEB,Amazon UK Marketpl,35.17,,13080.16
23/05/2016,DD,VIRGIN MEDIA PYMTS,27.99,,13115.33
23/05/2016,DD,CORGI HOMEPLAN CA,19.5,,13143.32
20/05/2016,CPT,LOYD WALES UNIV SW,50,,13162.82
18/05/2016,CPT,LOYD WALES UNIV SW,40,,13212.82
18/05/2016,BP,SAVE THE CHANGE,0.21,,13252.82
17/05/2016,DEB,Amazon UK Marketpl,5.79,,13253.03
17/05/2016,BP,SAVE THE CHANGE,1.34,,13258.82
16/05/2016,DEB,Amazon UK Retail,17.17,,13260.16
16/05/2016,DEB,Amazon UK Marketpl,11.5,,13277.33
16/05/2016,DEB,Amazon UK Retail,9.99,,13288.83
16/05/2016,DD,O2,21.82,,13298.82
13/05/2016,BP,SAVE THE CHANGE,0.32,,13320.64
13/05/2016,BGC,SWANSEA UNIVERSITY,,1019.74,13320.96
12/05/2016,DEB,Amazon UK Retail,7.99,,12301.22
12/05/2016,DEB,AMAZON MKTPLACE PM,6.69,,12309.21
12/05/2016,BP,SAVE THE CHANGE,0.22,,12315.9
11/05/2016,DEB,Amazon UK Retail,17.96,,12316.12
11/05/2016,DEB,Amazon UK Marketpl,12.82,,12334.08
11/05/2016,BP,SAVE THE CHANGE,1.42,,12346.9
10/05/2016,DEB,AMAZON MKTPLACE PM,15.1,,12348.32
10/05/2016,DEB,Amazon UK Marketpl,10.87,,12363.42
10/05/2016,DEB,Amazon UK Retail,8.97,,12374.29
10/05/2016,DEB,Amazon UK Marketpl,5.64,,12383.26
10/05/2016,BP,SAVE THE CHANGE,1.15,,12388.9
09/05/2016,DEB,Amazon UK Marketpl,5.82,,12390.05
09/05/2016,DEB,Amazon UK Marketpl,2.03,,12395.87
09/05/2016,DD,LV LIFE,37.12,,12397.9
06/05/2016,FPO,JAMES DAVIES,40,,12435.02
06/05/2016,BP,SAVE THE CHANGE,0.7,,12475.02
05/05/2016,FPO,JAMES DAVIES,240,,12475.72
05/05/2016,DEB,HAMPTON BY HILTON,99,,12715.72
05/05/2016,DEB,KLM UK  074174,168.3,,12814.72
05/05/2016,BP,SAVE THE CHANGE,0.01,,12983.02
04/05/2016,DEB,Amazon UK Marketpl,3.99,,12983.03
04/05/2016,DEB,EXPEDIA 1118747955,3,,12987.02
04/05/2016,BP,SAVE THE CHANGE,3.55,,12990.02
03/05/2016,FEE,ACCOUNT FEE,9.95,,12993.57
03/05/2016,,INTEREST (GROSS),,6.33,13003.52
03/05/2016,DEB,Amazon UK Marketpl,9.42,,12997.19
03/05/2016,DEB,Amazon UK Marketpl,2,,13006.61
03/05/2016,DEB,Amazon UK Marketpl,4.25,,13008.61
03/05/2016,DEB,Amazon UK Marketpl,3.95,,13012.86
03/05/2016,DEB,Amazon UK Marketpl,3.22,,13016.81
03/05/2016,DEB,Amazon UK Marketpl,2.27,,13020.03
03/05/2016,DEB,Amazon UK Retail,14.85,,13022.3
03/05/2016,DEB,Amazon UK Marketpl,6.49,,13037.15
03/05/2016,DD,NATWEST BANK,828.49,,13043.64
03/05/2016,DD,CC SWANSEA C.TAX,127,,13872.13
03/05/2016,DD,GOOD ENERGY GAS,43,,13999.13
03/05/2016,DD,ASSURANT INTER LTD,35.56,,14042.13
03/05/2016,DD,DWR CYMRU W WATER,29.5,,14077.69
03/05/2016,DD,GOOD ENERGY LTD,13,,14107.19
03/05/2016,DD,TV LICENCE MBP,12.12,,14120.19
03/05/2016,SO,ESAVINGS ACCOUNT,300,,14132.31
03/05/2016,BP,SAVE THE CHANGE,0.68,,14432.31
03/05/2016,CPT,LNK SWANSEA WIND S,60,,14432.99
29/04/2016,DEB,Amazon Svcs Europe,8.82,,14492.99
29/04/2016,DEB,Amazon UK Marketpl,8.5,,14501.81
29/04/2016,CPT,LOYD WALES UNIV SW,40,,14510.31
29/04/2016,DD,UCU B ACCOUNT,22.37,,14550.31
29/04/2016,BGC,SWANSEA UNI - PAY,,3085.64,14572.68
28/04/2016,BP,SAVE THE CHANGE,1.25,,11487.04
27/04/2016,DEB,Amazon UK Marketpl,23.49,,11488.29
27/04/2016,CPT,LOYD WALES UNIV SW,50,,11511.78
27/04/2016,DEB,Amazon UK Marketpl,9.26,,11561.78
26/04/2016,BP,SAVE THE CHANGE,1.46,,11571.04
25/04/2016,DEB,Amazon UK Retail,34.99,,11572.5
25/04/2016,DEB,Amazon UK Marketpl,16.45,,11607.49
25/04/2016,DEB,Amazon UK Marketpl,13.99,,11623.94
25/04/2016,DEB,Amazon UK Marketpl,3.87,,11637.93
25/04/2016,DEB,Amazon UK Marketpl,12.86,,11641.8
25/04/2016,DEB,Amazon UK Marketpl,1.95,,11654.66
25/04/2016,DEB,Amazon UK Retail,26.43,,11656.61
25/04/2016,DD,CORGI HOMEPLAN CA,19.5,,11683.04
22/04/2016,CPT,LOYD WALES UNIV SW,40,,11702.54
22/04/2016,DEP,SWANSEA UNIVERSITY,,491.23,11742.54
22/04/2016,BP,SAVE THE CHANGE,0.07,,11251.31
21/04/2016,DEB,HMSHOST AMSTERDAM,21.93,,11251.38
21/04/2016,DD,VIRGIN MEDIA PYMTS,27.99,,11273.31
21/04/2016,BP,SAVE THE CHANGE,0.01,,11301.3
20/04/2016,DEB,Amazon UK Retail,11.99,,11301.31
19/04/2016,BP,SAVE THE CHANGE,0.99,,11313.3
18/04/2016,DEB,HMSHOST AMSTERDAM,30.22,,11314.29
18/04/2016,DEB,NON-STG PURCH FEE,1,,11344.51
18/04/2016,DEB,NON-STG TRANS FEE,0.14,,11345.51
18/04/2016,DEB,WWW.HOTSPOTSCHIPHO,4.79,,11345.65
18/04/2016,DD,O2,38.92,,11350.44
18/04/2016,BP,SAVE THE CHANGE,1.42,,11389.36
15/04/2016,DEB,Shop 1/ Fashion Sh,72.28,,11390.78
15/04/2016,DEB,ARRIVA TRAINS WALE,8.3,,11463.06
15/04/2016,BP,SAVE THE CHANGE,0.1,,11471.36
14/04/2016,DEB,JS ONLINE GROCERY,262.9,,11471.46
14/04/2016,CPT,LNK ARRIVA TRAINS,50,,11734.36
14/04/2016,BP,SAVE THE CHANGE,0.5,,11784.36
13/04/2016,DEB,W DAVIES & SON,12.5,,11784.86
13/04/2016,CPT,LOYD WALES UNIV SW,40,,11797.36
12/04/2016,DEB,THE BIKE HUB,35,,11837.36
12/04/2016,CPT,LOYD WALES UNIV SW,50,,11872.36
12/04/2016,BP,SAVE THE CHANGE,0.69,,11922.36
11/04/2016,FPO,A.MEADOWCROFT,40,,11923.05
11/04/2016,DEB,Amazon UK Retail,7.8,,11963.05
11/04/2016,DEB,Amazon UK Marketpl,1.51,,11970.85
11/04/2016,BP,SAVE THE CHANGE,0.6,,11972.36
08/04/2016,DEB,CHINA VISA SERVICE,176,,11972.96
08/04/2016,DEB,ARRIVA TRAINS WALE,87.4,,12148.96
08/04/2016,CPT,LOYD WALES UNIV SW,50,,12236.36
08/04/2016,DD,LV LIFE,37.12,,12286.36
08/04/2016,BP,SAVE THE CHANGE,0.1,,12323.48
07/04/2016,DEB,LUL TICKET MACHINE,4.9,,12323.58
07/04/2016,DEB,ST GILES HOTEL,239,,12328.48
06/04/2016,CPT,HFX  TOTTENHAM COU,50,,12567.48
06/04/2016,DD,CC SWANSEA C.TAX,125.44,,12617.48
06/04/2016,BP,SAVE THE CHANGE,0.1,,12742.92
05/04/2016,DEB,ARRIVA TRAINS WALE,101,,12743.02
05/04/2016,DEB,LUL TICKET MACHINE,4.9,,12844.02
05/04/2016,DD,ASSURANT INTER LTD,35.56,,12848.92
05/04/2016,BP,SAVE THE CHANGE,2.33,,12884.48
04/04/2016,DEB,Amazon UK Marketpl,74.99,,12886.81
04/04/2016,DEB,Amazon UK Marketpl,20.24,,12961.8
04/04/2016,DEB,Amazon *Mktplce EU,8.02,,12982.04
04/04/2016,DEB,Amazon UK Marketpl,5.42,,12990.06
04/04/2016,BP,SAVE THE CHANGE,0.15,,12995.48
01/04/2016,FEE,ACCOUNT FEE,9.95,,12995.63
01/04/2016,,INTEREST (NET),,5.07,13005.58
01/04/2016,DEB,Amazon UK Marketpl,3.85,,13000.51
01/04/2016,DD,NATWEST BANK,828.49,,13004.36
01/04/2016,DD,GOOD ENERGY GAS,43,,13832.85
01/04/2016,DD,DWR CYMRU W WATER,14.5,,13875.85
01/04/2016,DD,GOOD ENERGY LTD,13,,13890.35
01/04/2016,DD,TV LICENCE MBP,12.12,,13903.35
01/04/2016,SO,ESAVINGS ACCOUNT,300,,13915.47
01/04/2016,BP,SAVE THE CHANGE,1.31,,14215.47
31/03/2016,DEB,Amazon UK Retail,12.45,,14216.78
31/03/2016,DEB,Amazon UK Marketpl,10.24,,14229.23
31/03/2016,DD,UNIV & COL UNION,22.37,,14239.47
31/03/2016,BGC,SWANSEA UNIVERSITY,,3126.88,14261.84
30/03/2016,BP,SAVE THE CHANGE,2.14,,11134.96
29/03/2016,DEB,Amazon UK Marketpl,27.89,,11137.1
29/03/2016,DEB,Amazon UK Marketpl,17.95,,11164.99
29/03/2016,DEB,Amazon UK Marketpl,16.17,,11182.94
29/03/2016,DEB,POST OFFICE COUNTE,14.5,,11199.11
29/03/2016,DEB,Amazon UK Marketpl,6.56,,11213.61
29/03/2016,DEB,Amazon UK Marketpl,5.79,,11220.17
29/03/2016,CPT,LOYD WALES UNIV SW,30,,11225.96
24/03/2016,CPT,LOYD WALES UNIV SW,50,,11255.96
24/03/2016,BP,SAVE THE CHANGE,0.2,,11305.96
23/03/2016,DEB,ARRIVA TRAINS WALE,91.8,,11306.16
22/03/2016,DEB,Amazon UK Marketpl,18,,11397.96
22/03/2016,DD,CORGI HOMEPLAN CA,19.5,,11415.96
22/03/2016,BP,SAVE THE CHANGE,0.52,,11435.46
21/03/2016,DEB,Amazon UK Retail,7.5,,11435.98
21/03/2016,DEB,Amazon UK Marketpl,4.98,,11443.48
21/03/2016,DD,VIRGIN MEDIA PYMTS,27.99,,11448.46
21/03/2016,BP,SAVE THE CHANGE,0.14,,11476.45
18/03/2016,DEB,Amazon UK Marketpl,19.99,,11476.59
18/03/2016,DEB,Amazon UK Marketpl,2.87,,11496.58
18/03/2016,CPT,LOYD WALES UNIV SW,50,,11499.45
18/03/2016,BP,SAVE THE CHANGE,2,,11549.45
17/03/2016,DEB,Amazon Svcs Europe,17.24,,11551.45
17/03/2016,DEB,POST OFFICE COUNTE,14.5,,11568.69
17/03/2016,DEB,Amazon UK Marketpl,4.26,,11583.19
17/03/2016,BP,SAVE THE CHANGE,2.68,,11587.45
16/03/2016,DEB,WWW.COLSTONHALL.OR,85.35,,11590.13
16/03/2016,DEB,Amazon UK Retail,12.35,,11675.48
16/03/2016,DEB,Amazon UK Retail,11.99,,11687.83
16/03/2016,DEB,Amazon UK Marketpl,11.41,,11699.82
16/03/2016,DEB,Amazon Svcs Europe,10.22,,11711.23
16/03/2016,CPT,LOYD WALES UNIV SW,50,,11721.45
16/03/2016,DD,O2,18.21,,11771.45
15/03/2016,BP,SAVE THE CHANGE,0.91,,11789.66
14/03/2016,DEB,AMAZON MKTPLACE PM,26.85,,11790.57
14/03/2016,DEB,Amazon Svcs Europe,2.75,,11817.42
14/03/2016,DEB,NON-STG PURCH FEE,1,,11820.17
14/03/2016,DEB,NON-STG TRANS FEE,0.1,,11821.17
14/03/2016,DEB,RLR-CC.COM 1 88846,3.49,,11821.27
14/03/2016,BP,SAVE THE CHANGE,0.72,,11824.76
14/03/2016,BGC,UNIOF WARWICK,,101.45,11825.48
14/03/2016,DEB,NON-STG PURCH FEE,1,,11724.03
14/03/2016,DEB,NON-STG TRANS FEE,0.1,,11725.03
14/03/2016,DEB,ACTBLUE*BERNIE.SAN,3.54,,11725.13
11/03/2016,DEB,Amazon UK Marketpl,10.74,,11728.67
10/03/2016,CHQ,45,1100,,11739.41
09/03/2016,DEB,Amazon Prime,79,,12839.41
09/03/2016,DD,LV LIFE,37.12,,12918.41
09/03/2016,BP,SAVE THE CHANGE,0.58,,12955.53
08/03/2016,DEB,AMAZON MKTPLACE PM,12.42,,12956.11
07/03/2016,BP,SAVE THE CHANGE,0.43,,12968.53
04/03/2016,DEB,NON-STG PURCH FEE,1,,12968.96
04/03/2016,DEB,NON-STG TRANS FEE,0.1,,12969.96
04/03/2016,DEB,ACTBLUE*BERNIE.SAN,3.57,,12970.06
04/03/2016,CPT,LOYD WALES UNIV SW,50,,12973.63
04/03/2016,BP,SAVE THE CHANGE,0.55,,13023.63
03/03/2016,DEB,JS ONLINE GROCERY,241.45,,13024.18
03/03/2016,DD,ASSURANT INTER LTD,35.56,,13265.63
03/03/2016,BP,SAVE THE CHANGE,0.51,,13301.19
02/03/2016,DEB,Amazon UK Retail,10.49,,13301.7
02/03/2016,TFR,F/FLOW UNIVERSITY,,907.92,13312.19
02/03/2016,BP,SAVE THE CHANGE,0.05,,12404.27
01/03/2016,FEE,ACCOUNT FEE,9.95,,12404.32
01/03/2016,,INTEREST (NET),,4.74,12414.27
01/03/2016,DEB,Amazon UK Marketpl,49.95,,12409.53
01/03/2016,DD,NATWEST BANK,828.49,,12459.48
01/03/2016,DD,GOOD ENERGY GAS,43,,13287.97
01/03/2016,DD,DWR CYMRU W WATER,14.5,,13330.97
01/03/2016,DD,GOOD ENERGY LTD,13,,13345.47
01/03/2016,DD,TV LICENCE MBP,12.12,,13358.47
01/03/2016,SO,ESAVINGS ACCOUNT,300,,13370.59
29/02/2016,DEB,IKEA ONLINE,98,,13670.59
29/02/2016,DD,UNIV & COL UNION,22.37,,13768.59
29/02/2016,BGC,SWANSEA UNIVERSITY,,3127.28,13790.96
26/02/2016,CPT,LOYD WALES UNIV SW,50,,10663.68
26/02/2016,BGC,SWANSEA UNIVERSITY,,964.6,10713.68
25/02/2016,CHQ,44,50,,9749.08
24/02/2016,BP,SAVE THE CHANGE,0.01,,9799.08
23/02/2016,DEB,Amazon UK Retail,11.99,,9799.09
23/02/2016,CPT,LOYD WALES UNIV SW,40,,9811.08
23/02/2016,FPO,A.MEADOWCROFT,65,,9851.08
23/02/2016,BP,SAVE THE CHANGE,0.56,,9916.08
22/02/2016,DEB,Amazon UK Marketpl,37.69,,9916.64
22/02/2016,DEB,Amazon UK Retail,10,,9954.33
22/02/2016,DEB,Amazon UK Marketpl,4.75,,9964.33
22/02/2016,DD,VIRGIN MEDIA PYMTS,27.99,,9969.08
19/02/2016,CPT,LOYD WALES UNIV SW,30,,9997.07
19/02/2016,BP,SAVE THE CHANGE,0.67,,10027.07
18/02/2016,DEB,Amazon UK Marketpl,12.99,,10027.74
18/02/2016,DEB,Amazon UK Marketpl,1.34,,10040.73
18/02/2016,BP,SAVE THE CHANGE,1.35,,10042.07
17/02/2016,DEB,ARRIVA TRAINS WALE,73.5,,10043.42
17/02/2016,DEB,Amazon UK Marketpl,21.16,,10116.92
17/02/2016,DEB,Amazon UK Marketpl,19.99,,10138.08
16/02/2016,CPT,LNK ARRIVA TRAINS,50,,10158.07
16/02/2016,DD,O2,18.92,,10208.07
16/02/2016,BP,SAVE THE CHANGE,0.92,,10226.99
15/02/2016,DEB,Amazon UK Retail,21.09,,10227.91
15/02/2016,DEB,Amazon UK Retail,7,,10249
15/02/2016,DEB,Amazon UK Marketpl,3.99,,10256
15/02/2016,DEP,SWANSEA UNIVERSITY,,18,10259.99
12/02/2016,CPT,LOYD WALES UNIV SW,20,,10241.99
11/02/2016,CPT,LOYD WALES UNIV SW,40,,10261.99
10/02/2016,BP,SAVE THE CHANGE,0.01,,10301.99
09/02/2016,DEB,Amazon UK Retail,17.99,,10302
09/02/2016,DEB,Amazon UK Retail,5,,10319.99
08/02/2016,DD,LV LIFE,37.12,,10324.99
08/02/2016,FPO,A.MEADOWCROFT,90,,10362.11
05/02/2016,CPT,LOYD WALES UNIV SW,100,,10452.11
04/02/2016,CPT,LOYD WALES UNIV SW,100,,10552.11
04/02/2016,BP,SAVE THE CHANGE,0.25,,10652.11
03/02/2016,DEB,Amazon UK Marketpl,8.75,,10652.36
03/02/2016,DD,ASSURANT INTER LTD,35.56,,10661.11
02/02/2016,CPT,LOYD WALES UNIV SW,50,,10696.67
02/02/2016,BP,SAVE THE CHANGE,1.33,,10746.67
01/02/2016,FEE,ACCOUNT FEE,9.95,,10748
01/02/2016,,INTEREST (NET),,4.57,10757.95
01/02/2016,DEB,Amazon UK Marketpl,26.55,,10753.38
01/02/2016,DEB,Amazon UK Marketpl,19.28,,10779.93
01/02/2016,DEB,Amazon UK Marketpl,9.84,,10799.21
01/02/2016,DD,NATWEST BANK,828.49,,10809.05
01/02/2016,DD,CC SWANSEA C.TAX,122,,11637.54
01/02/2016,DD,GOOD ENERGY GAS,43,,11759.54
01/02/2016,DD,DWR CYMRU W WATER,14.5,,11802.54
01/02/2016,DD,GOOD ENERGY LTD,13,,11817.04
01/02/2016,DD,TV LICENCE MBP,12.12,,11830.04
01/02/2016,SO,ESAVINGS ACCOUNT,300,,11842.16
01/02/2016,BP,SAVE THE CHANGE,0.85,,12142.16
29/01/2016,DEB,Amazon UK Marketpl,1.15,,12143.01
29/01/2016,CPT,LOYD WALES UNIV SW,50,,12144.16
29/01/2016,DD,UNIV & COL UNION,22.37,,12194.16
29/01/2016,BGC,SWANSEA UNIVERSITY,,3126.88,12216.53
27/01/2016,BP,SAVE THE CHANGE,1.32,,9089.65
26/01/2016,DEB,Amazon UK Retail,17.17,,9090.97
26/01/2016,DEB,Amazon UK Marketpl,9.99,,9108.14
26/01/2016,DEB,Amazon UK Marketpl,7.98,,9118.13
26/01/2016,DEB,Amazon UK Marketpl,5.9,,9126.11
26/01/2016,DEB,Amazon UK Marketpl,3.64,,9132.01
26/01/2016,CPT,LOYD WALES UNIV SW,50,,9135.65
25/01/2016,BP,SAVE THE CHANGE,0.39,,9185.65
22/01/2016,DEB,NON-STG PURCH FEE,1,,9186.04
22/01/2016,DEB,NON-STG TRANS FEE,20.41,,9187.04
22/01/2016,DEB,HILTON HTL UNIV OF,682.61,,9207.45
21/01/2016,DD,VIRGIN MEDIA PYMTS,16.91,,9890.06
21/01/2016,DEB,NON-STG CASH FEE,2,,9906.97
21/01/2016,DEB,NON-STG TRANS FEE,2.16,,9908.97
21/01/2016,DEB,*UNIVERSITY OF HOU,72.51,,9911.13
20/01/2016,BP,SAVE THE CHANGE,0.55,,9983.64
19/01/2016,DEB,NON-STG PURCH FEE,1,,9984.19
19/01/2016,DEB,NON-STG TRANS FEE,0.52,,9985.19
19/01/2016,DEB,UNITED  016260,17.45,,9985.71
19/01/2016,BP,SAVE THE CHANGE,0.8,,10003.16
18/01/2016,DEB,NON-STG PURCH FEE,1,,10003.96
18/01/2016,DEB,NON-STG TRANS FEE,4.55,,10004.96
18/01/2016,DEB,HOLIDAY INN HOUSTO,152.2,,10009.51
18/01/2016,DD,O2,16.62,,10161.71
12/01/2016,BP,SAVE THE CHANGE,1.94,,10178.33
11/01/2016,DEB,NON-STG PURCH FEE,1,,10180.27
11/01/2016,DEB,NON-STG TRANS FEE,0.55,,10181.27
11/01/2016,DEB,HOUSTON GEORGE BUS,18.59,,10181.82
11/01/2016,DEB,NON-STG PURCH FEE,1,,10200.41
11/01/2016,DEB,NON-STG TRANS FEE,0.51,,10201.41
11/01/2016,DEB,UNITED  016260,17.18,,10201.92
11/01/2016,DEB,Amazon UK Marketpl,14.29,,10219.1
11/01/2016,BP,SAVE THE CHANGE,0.16,,10233.39
08/01/2016,DEB,Amazon UK Retail,34.99,,10233.55
08/01/2016,DEB,Amazon UK Marketpl,7.85,,10268.54
08/01/2016,CPT,LOYD WALES UNIV SW,40,,10276.39
08/01/2016,DD,LV LIFE,37.12,,10316.39
08/01/2016,BP,SAVE THE CHANGE,1.2,,10353.51
07/01/2016,DEB,JS ONLINE GROCERY,231.6,,10354.71
07/01/2016,DEB,AMAZON MKTPLACE PM,16.2,,10586.31
07/01/2016,CPT,LOYD WALES UNIV SW,100,,10602.51
07/01/2016,BP,SAVE THE CHANGE,0.77,,10702.51
06/01/2016,DEB,Amazon UK Marketpl,11.75,,10703.28
06/01/2016,DEB,Amazon UK Marketpl,5.5,,10715.03
06/01/2016,DEB,Amazon UK Marketpl,3.98,,10720.53
05/01/2016,CPT,LOYD WALES UNIV SW,100,,10724.51
05/01/2016,BP,SAVE THE CHANGE,0.15,,10824.51
04/01/2016,FEE,ACCOUNT FEE,9.95,,10824.66
04/01/2016,,INTEREST (NET),,5.56,10834.61
04/01/2016,DEB,Amazon UK Retail,8.99,,10829.05
04/01/2016,DEB,Amazon UK Marketpl,1.86,,10838.04
04/01/2016,DD,NATWEST BANK,828.49,,10839.9
04/01/2016,DD,CC SWANSEA C.TAX,122,,11668.39
04/01/2016,DD,GOOD ENERGY GAS,43,,11790.39
04/01/2016,DD,ASSURANT INTER LTD,35.56,,11833.39
04/01/2016,DD,DWR CYMRU W WATER,14.5,,11868.95
04/01/2016,DD,GOOD ENERGY LTD,13,,11883.45
04/01/2016,DD,TV LICENCE MBP,12.12,,11896.45
04/01/2016,SO,ESAVINGS ACCOUNT,300,,11908.57
04/01/2016,BP,SAVE THE CHANGE,1.97,,12208.57
04/01/2016,CPT,LNK THE COOPERATIV,40,,12210.54
31/12/2015,DEB,Amazon UK Retail,26.93,,12250.54
31/12/2015,DEB,Amazon UK Retail,8.97,,12277.47
31/12/2015,DEB,Amazon UK Marketpl,8.36,,12286.44
31/12/2015,DEB,Amazon UK Marketpl,2.55,,12294.8
31/12/2015,DEB,PAYPAL *CARL DAVIE,47.22,,12297.35
31/12/2015,DD,UNIV & COL UNION,22.37,,12344.57
31/12/2015,BP,SAVE THE CHANGE,3.39,,12366.94
30/12/2015,DEB,LUSH RETAIL LTD,47.29,,12370.33
30/12/2015,DEB,SPORTSDIRECT 141,19.99,,12417.62
30/12/2015,DEB,EXOTICA,13.14,,12437.61
30/12/2015,DEB,Amazon UK Marketpl,6.2,,12450.75
30/12/2015,DEB,Amazon UK Marketpl,4.98,,12456.95
30/12/2015,DEB,Amazon Svcs Europe,3.94,,12461.93
30/12/2015,DEB,Amazon Svcs Europe,2.07,,12465.87
30/12/2015,BP,SAVE THE CHANGE,0.21,,12467.94
29/12/2015,DEB,Amazon UK Marketpl,117.99,,12468.15
29/12/2015,DEB,SAINSBURYS - SWANS,22.85,,12586.14
29/12/2015,DEB,Amazon UK Marketpl,32.95,,12608.99
29/12/2015,DEB,CO-OP GROUP FOOD,19,,12641.94
29/12/2015,DEB,Amazon UK Retail,12,,12660.94
24/12/2015,BP,SAVE THE CHANGE,0.13,,12672.94
24/12/2015,BGC,SWANSEA UNIVERSITY,,1612.63,12673.07
23/12/2015,DEB,Amazon UK Marketpl,1.87,,11060.44
23/12/2015,BP,SAVE THE CHANGE,0.8,,11062.31
22/12/2015,DEB,Amazon UK Marketpl,9.2,,11063.11
22/12/2015,CPT,LOYD WALES UNIV SW,50,,11072.31
22/12/2015,BP,SAVE THE CHANGE,1.54,,11122.31
21/12/2015,DEB,ODEON/BOOKIT,26,,11123.85
21/12/2015,DEB,Amazon UK Marketpl,17.99,,11149.85
21/12/2015,DEB,UNITED AIR  016936,117.7,,11167.84
21/12/2015,DEB,Amazon UK Marketpl,29.68,,11285.54
21/12/2015,DEB,GODADDY COM EUROPE,12.2,,11315.22
21/12/2015,DEB,EXPEDIA 1104152727,10,,11327.42
21/12/2015,DEB,Amazon UK Marketpl,6.97,,11337.42
21/12/2015,DEB,Amazon UK Marketpl,1.92,,11344.39
21/12/2015,DD,VIRGIN MEDIA PYMTS,37.78,,11346.31
21/12/2015,BP,SAVE THE CHANGE,1.65,,11384.09
21/12/2015,BGC,SWANSEA UNIVERSITY,,3127.28,11385.74
18/12/2015,DEB,Amazon UK Marketpl,4.28,,8258.46
18/12/2015,DEB,Amazon UK Marketpl,1.07,,8262.74
17/12/2015,BP,SAVE THE CHANGE,0.01,,8263.81
16/12/2015,DEB,Amazon UK Marketpl,9.99,,8263.82
16/12/2015,CPT,LOYD WALES UNIV SW,40,,8273.81
16/12/2015,DD,O2,17.42,,8313.81
16/12/2015,BP,SAVE THE CHANGE,0.11,,8331.23
15/12/2015,DEB,PUB ON THE POND,28.99,,8331.34
15/12/2015,DEB,Amazon UK Marketpl,13.9,,8360.33
15/12/2015,CPT,LOYD WALES UNIV SW,50,,8374.23
15/12/2015,BP,SAVE THE CHANGE,0.15,,8424.23
14/12/2015,DEB,Amazon UK Retail,21.99,,8424.38
14/12/2015,DEB,Amazon Svcs Europe,5.98,,8446.37
14/12/2015,DEB,Amazon UK Marketpl,7.88,,8452.35
14/12/2015,DEB,WIKIMEDIA,2,,8460.23
14/12/2015,BP,SAVE THE CHANGE,0.64,,8462.23
11/12/2015,DEB,Amazon UK Retail,119.99,,8462.87
11/12/2015,DEB,SUSU TRADING LTD,44.53,,8582.86
11/12/2015,DEB,Amazon UK Marketpl,14.85,,8627.39
11/12/2015,DEB,Amazon UK Retail,3.99,,8642.24
10/12/2015,CHQ,43,200,,8646.23
10/12/2015,BP,SAVE THE CHANGE,1.29,,8846.23
09/12/2015,DEB,AMAZON MKTPLACE PM,10.74,,8847.52
09/12/2015,DEB,Amazon UK Marketpl,4.7,,8858.26
09/12/2015,DEB,Amazon UK Marketpl,2.27,,8862.96
09/12/2015,DEB,SKYPE SUBSCRIPTION,10,,8865.23
09/12/2015,DD,LV LIFE,37.12,,8875.23
08/12/2015,BP,SAVE THE CHANGE,2.17,,8912.35
07/12/2015,DEB,Amazon UK Marketpl,23.99,,8914.52
07/12/2015,DEB,Amazon UK Retail,13.36,,8938.51
07/12/2015,DEB,Amazon UK Retail,11.99,,8951.87
07/12/2015,DEB,Amazon UK Retail,3.87,,8963.86
07/12/2015,DEB,NON-STG PURCH FEE,1,,8967.73
07/12/2015,DEB,NON-STG TRANS FEE,6.23,,8968.73
07/12/2015,DEB,ACTIVATORME,208.38,,8974.96
07/12/2015,DEB,Amazon UK Marketpl,9.24,,9183.34
07/12/2015,BP,SAVE THE CHANGE,1.23,,9192.58
04/12/2015,DEB,Amazon UK Marketpl,7.74,,9193.81
04/12/2015,DEB,Amazon UK Marketpl,2.03,,9201.55
04/12/2015,BP,SAVE THE CHANGE,0.8,,9203.58
03/12/2015,DEB,JS ONLINE GROCERY,266.6,,9204.38
03/12/2015,DEB,Amazon UK Marketpl,4.6,,9470.98
03/12/2015,DD,ASSURANT INTER LTD,35.56,,9475.58
03/12/2015,BP,SAVE THE CHANGE,0.17,,9511.14
02/12/2015,DEB,Amazon UK Marketpl,10.83,,9511.31
02/12/2015,BP,SAVE THE CHANGE,1.15,,9522.14
01/12/2015,FEE,ACCOUNT FEE,9.95,,9523.29
01/12/2015,,INTEREST (NET),,4.74,9533.24
01/12/2015,DEB,Amazon Svcs Europe,6.6,,9528.5
01/12/2015,DEB,Amazon UK Marketpl,2.25,,9535.1
01/12/2015,DD,NATWEST BANK,828.49,,9537.35
01/12/2015,DD,CC SWANSEA C.TAX,122,,10365.84
01/12/2015,DD,GOOD ENERGY GAS,43,,10487.84
01/12/2015,DD,DWR CYMRU W WATER,14.5,,10530.84
01/12/2015,DD,GOOD ENERGY LTD,13,,10545.34
01/12/2015,DD,TV LICENCE MBP,12.18,,10558.34
01/12/2015,SO,ESAVINGS ACCOUNT,300,,10570.52
01/12/2015,BP,SAVE THE CHANGE,1.34,,10870.52
30/11/2015,DEB,Amazon UK Marketpl,11.99,,10871.86
30/11/2015,DEB,Amazon UK Marketpl,6.95,,10883.85
30/11/2015,DEB,Amazon UK Retail,5.49,,10890.8
30/11/2015,DEB,Amazon UK Marketpl,2.99,,10896.29
30/11/2015,DEB,Amazon UK Marketpl,2.24,,10899.28
30/11/2015,DD,UNIV & COL UNION,22.37,,10901.52
30/11/2015,BP,SAVE THE CHANGE,0.75,,10923.89
30/11/2015,BGC,SWANSEA UNIVERSITY,,3199.54,10924.64
27/11/2015,DEB,SAINSBURYS - SWANS,12.25,,7725.1
26/11/2015,CPT,SBY  SWANSEA UPL C,50,,7737.35
26/11/2015,BP,SAVE THE CHANGE,0.52,,7787.35
25/11/2015,DEB,Amazon UK Marketpl,22.54,,7787.87
25/11/2015,DEB,Amazon UK Marketpl,1.94,,7810.41
25/11/2015,CPT,LOYD WALES UNIV SW,50,,7812.35
25/11/2015,BP,SAVE THE CHANGE,2.71,,7862.35
24/11/2015,DEB,Amazon UK Retail,7.99,,7865.06
24/11/2015,DEB,Amazon UK Marketpl,7.39,,7873.05
24/11/2015,DEB,Amazon UK Marketpl,6.59,,7880.44
24/11/2015,DEB,Amazon UK Marketpl,2.25,,7887.03
24/11/2015,DEB,Amazon UK Marketpl,1.07,,7889.28
24/11/2015,BP,SAVE THE CHANGE,2.31,,7890.35
23/11/2015,DEB,Amazon UK Retail,16.11,,7892.66
23/11/2015,DEB,Amazon UK Retail,7.49,,7908.77
23/11/2015,DEB,Amazon UK Marketpl,30.27,,7916.26
23/11/2015,DEB,Amazon UK Marketpl,6.89,,7946.53
23/11/2015,DEB,Amazon UK Marketpl,2.93,,7953.42
23/11/2015,DD,VIRGIN MEDIA PYMTS,37.78,,7956.35
20/11/2015,BP,SAVE THE CHANGE,0.9,,7994.13
19/11/2015,DEB,GWR STOKE GIFF SST,26.1,,7995.03
19/11/2015,BP,SAVE THE CHANGE,1.7,,8021.13
18/11/2015,DEB,IZ *Friska Ltd,5.25,,8022.83
18/11/2015,DEB,PREMIER INN4401262,109.05,,8028.08
18/11/2015,DEB,CLKBANK*COM_REFUND,,39.62,8137.13
17/11/2015,CPT,LNK UNION STREET,20,,8097.51
17/11/2015,BP,SAVE THE CHANGE,2.95,,8117.51
16/11/2015,DEB,Amazon UK Marketpl,13.64,,8120.46
16/11/2015,DEB,Amazon UK Retail,4.72,,8134.1
16/11/2015,DEB,Amazon UK Marketpl,2.02,,8138.82
16/11/2015,DEB,Amazon UK Marketpl,0.82,,8140.84
16/11/2015,DEB,Amazon UK Retail,27.46,,8141.66
16/11/2015,DEB,Amazon UK Marketpl,3.39,,8169.12
16/11/2015,DD,O2,19.02,,8172.51
13/11/2015,BP,SAVE THE CHANGE,0.85,,8191.53
12/11/2015,DEB,Amazon UK Marketpl,11.95,,8192.38
12/11/2015,DEB,Amazon UK Retail,5.2,,8204.33
12/11/2015,BP,SAVE THE CHANGE,0.61,,8209.53
11/11/2015,DEB,Amazon UK Retail,8.39,,8210.14
11/11/2015,BP,SAVE THE CHANGE,0.62,,8218.53
10/11/2015,DEB,Amazon UK Retail,35.38,,8219.15
10/11/2015,BP,SAVE THE CHANGE,0.04,,8254.53
09/11/2015,DEB,Amazon UK Marketpl,20.97,,8254.57
09/11/2015,DEB,Amazon UK Marketpl,4.99,,8275.54
09/11/2015,DD,LV LIFE,37.12,,8280.53
09/11/2015,BP,SAVE THE CHANGE,0.99,,8317.65
06/11/2015,DEB,Amazon UK Marketpl,4.01,,8318.64
06/11/2015,BP,SAVE THE CHANGE,0.72,,8322.65
05/11/2015,DEB,Amazon UK Marketpl,12.99,,8323.37
05/11/2015,DEB,Amazon UK Retail,9.29,,8336.36
05/11/2015,BP,SAVE THE CHANGE,1.32,,8345.65
04/11/2015,DEB,Amazon UK Marketpl,9.59,,8346.97
04/11/2015,DEB,Amazon UK Marketpl,4.09,,8356.56
04/11/2015,BP,SAVE THE CHANGE,1.38,,8360.65
03/11/2015,DEB,Amazon UK Marketpl,57.47,,8362.03
03/11/2015,DEB,Amazon UK Retail,12.39,,8419.5
03/11/2015,DD,ASSURANT INTER LTD,35.56,,8431.89
03/11/2015,DEB,NON-STG PURCH FEE,1,,8467.45
03/11/2015,DEB,NON-STG TRANS FEE,27.2,,8468.45
03/11/2015,DEB,HILTON HOTELS PALM,909.76,,8495.65
03/11/2015,BP,SAVE THE CHANGE,0.46,,9405.41
02/11/2015,FEE,ACCOUNT FEE,9.95,,9405.87
02/11/2015,,INTEREST (NET),,5.23,9415.82
02/11/2015,DEB,Amazon UK Marketpl,1.59,,9410.59
02/11/2015,DEB,Amazon UK Marketpl,3.95,,9412.18
02/11/2015,DD,NATWEST BANK,748.13,,9416.13
02/11/2015,DD,GOOD ENERGY GAS,43,,10164.26
02/11/2015,DD,DWR CYMRU W WATER,14.5,,10207.26
02/11/2015,DD,GOOD ENERGY LTD,13,,10221.76
02/11/2015,DD,TV LICENCE MBP,12.12,,10234.76
02/11/2015,SO,ESAVINGS ACCOUNT,300,,10246.88
02/11/2015,BP,SAVE THE CHANGE,1.14,,10546.88
30/10/2015,DD,UNIV & COL UNION,22.37,,10548.02
30/10/2015,DEB,NON-STG CASH FEE,2,,10570.39
30/10/2015,DEB,NON-STG TRANS FEE,3.91,,10572.39
30/10/2015,DEB,17 E MONROE ST LBB,130.94,,10576.3
30/10/2015,DEB,NON-STG PURCH FEE,1,,10707.24
30/10/2015,DEB,NON-STG TRANS FEE,0.74,,10708.24
30/10/2015,DEB,FEELINGS GIFT SHOP,25.03,,10708.98
30/10/2015,DEB,NON-STG PURCH FEE,1,,10734.01
30/10/2015,DEB,NON-STG TRANS FEE,0.32,,10735.01
30/10/2015,DEB,FRESHII - 653,10.83,,10735.33
30/10/2015,BP,SAVE THE CHANGE,0.18,,10746.16
30/10/2015,BGC,SWANSEA UNIVERSITY,,3064.27,10746.34
29/10/2015,DEB,NON-STG PURCH FEE,1,,7682.07
29/10/2015,DEB,NON-STG TRANS FEE,3.1,,7683.07
29/10/2015,DEB,SKECHERS-USA #229,103.82,,7686.17
29/10/2015,BP,SAVE THE CHANGE,0.35,,7789.99
28/10/2015,DEB,NON-STG PURCH FEE,1,,7790.34
28/10/2015,DEB,NON-STG TRANS FEE,0.88,,7791.34
28/10/2015,DEB,ITALIAN VILLAGE,29.65,,7792.22
28/10/2015,BP,SAVE THE CHANGE,0.01,,7821.87
27/10/2015,DEB,CITY FLOWERS,9.99,,7821.88
27/10/2015,BP,SAVE THE CHANGE,0.26,,7831.87
26/10/2015,DEB,NON-STG PURCH FEE,1,,7832.13
26/10/2015,DEB,NON-STG TRANS FEE,4.5,,7833.13
26/10/2015,DEB,HILTON HOTELS PALM,150.74,,7837.63
26/10/2015,BP,SAVE THE CHANGE,0.6,,7988.37
23/10/2015,DEB,SUSU TRADING LTD,59.4,,7988.97
22/10/2015,CPT,LNK FULTON HOUSE,142.86,,8048.37
22/10/2015,CPT,LOYD WALES UNIV SW,150,,8191.23
22/10/2015,BP,SAVE THE CHANGE,0.95,,8341.23
21/10/2015,DEB,Amazon UK Marketpl,5.05,,8342.18
21/10/2015,DD,VIRGIN MEDIA PYMTS,37.78,,8347.23
21/10/2015,BP,SAVE THE CHANGE,0.05,,8385.01
20/10/2015,DEB,Amazon UK Marketpl,3.95,,8385.06
20/10/2015,BP,SAVE THE CHANGE,0.33,,8389.01
19/10/2015,DEB,JS ONLINE GROCERY,242.7,,8389.34
19/10/2015,DEB,Amazon UK Marketpl,6.97,,8632.04
19/10/2015,DEB,JS ONLINE GROCERY,,4.4,8639.01
16/10/2015,CPT,LOYD WALES UNIV SW,50,,8634.61
16/10/2015,DD,O2,32.55,,8684.61
16/10/2015,BP,SAVE THE CHANGE,0.05,,8717.16
15/10/2015,DEB,Amazon UK Marketpl,24.95,,8717.21
15/10/2015,BP,SAVE THE CHANGE,0.1,,8742.16
14/10/2015,DEB,Amazon UK Marketpl,9.9,,8742.26
14/10/2015,BP,SAVE THE CHANGE,0.57,,8752.16
13/10/2015,DEB,Amazon UK Marketpl,11.95,,8752.73
13/10/2015,DEB,Amazon UK Marketpl,4.48,,8764.68
13/10/2015,BP,SAVE THE CHANGE,0.32,,8769.16
12/10/2015,DEB,CLKBANK*COM_YS2DQ7,16.68,,8769.48
12/10/2015,BP,SAVE THE CHANGE,0.21,,8786.16
09/10/2015,DEB,Amazon UK Marketpl,6.79,,8786.37
09/10/2015,DD,LV LIFE,37.12,,8793.16
09/10/2015,BP,SAVE THE CHANGE,0.63,,8830.28
08/10/2015,DEB,Amazon Svcs Europe,17.4,,8830.91
08/10/2015,DEB,Amazon UK Retail,8.97,,8848.31
08/10/2015,BP,SAVE THE CHANGE,0.32,,8857.28
07/10/2015,DEB,Amazon UK Marketpl,13.99,,8857.6
07/10/2015,DEB,Amazon UK Marketpl,4.69,,8871.59
07/10/2015,CHQ,42,418,,8876.28
07/10/2015,BP,SAVE THE CHANGE,0.74,,9294.28
06/10/2015,DEB,ITUNES.COM/BILL,3.99,,9295.02
06/10/2015,DEB,Amazon UK Marketpl,1.27,,9299.01
06/10/2015,BP,SAVE THE CHANGE,2.01,,9300.28
05/10/2015,DEB,Amazon UK Retail,12.99,,9302.29
05/10/2015,DEB,Amazon UK Marketpl,7.98,,9315.28
05/10/2015,DEB,Amazon UK Marketpl,7.66,,9323.26
05/10/2015,DEB,Amazon UK Marketpl,6.95,,9330.92
05/10/2015,DEB,Amazon UK Marketpl,6.95,,9337.87
05/10/2015,DEB,Amazon UK Marketpl,6.23,,9344.82
05/10/2015,DEB,Amazon UK Marketpl,5.88,,9351.05
05/10/2015,DEB,Amazon UK Marketpl,4.35,,9356.93
05/10/2015,DD,ASSURANT INTER LTD,35.56,,9361.28
05/10/2015,BP,SAVE THE CHANGE,2.5,,9396.84
02/10/2015,DEB,NATIONAL WESTMINST,1030,,9399.34
02/10/2015,DEB,Amazon UK Marketpl,17.16,,10429.34
02/10/2015,DEB,Amazon UK Marketpl,11.1,,10446.5
02/10/2015,DEB,Amazon UK Marketpl,3.24,,10457.6
02/10/2015,CPT,LOYD WALES UNIV SW,50,,10460.84
02/10/2015,BP,SAVE THE CHANGE,0.52,,10510.84
01/10/2015,FEE,ACCOUNT FEE,9.95,,10511.36
01/10/2015,,INTEREST (NET),,4.9,10521.31
01/10/2015,DEB,Amazon UK Retail,17.49,,10516.41
01/10/2015,DEB,Amazon UK Retail,14.99,,10533.9
01/10/2015,DD,NATWEST BANK,748.13,,10548.89
01/10/2015,DD,CC SWANSEA C.TAX,122,,11297.02
01/10/2015,DD,GOOD ENERGY GAS,43,,11419.02
01/10/2015,DD,DWR CYMRU W WATER,14.5,,11462.02
01/10/2015,DD,GOOD ENERGY LTD,13,,11476.52
01/10/2015,DD,TV LICENCE MBP,12.12,,11489.52
01/10/2015,SO,ESAVINGS ACCOUNT,300,,11501.64
01/10/2015,BP,SAVE THE CHANGE,1.01,,11801.64
30/09/2015,DEB,Amazon UK Marketpl,5.04,,11802.65
30/09/2015,DEB,Amazon UK Marketpl,4.95,,11807.69
30/09/2015,DD,UNIV & COL UNION,22.37,,11812.64
30/09/2015,BP,SAVE THE CHANGE,0.76,,11835.01
30/09/2015,BGC,SWANSEA UNIVERSITY,,3043.03,11835.77
29/09/2015,DEB,UPLANDS CHIROPRACT,50,,8792.74
29/09/2015,DEB,Amazon UK Marketpl,3.24,,8842.74
29/09/2015,BP,SAVE THE CHANGE,1.89,,8845.98
28/09/2015,DEB,Amazon UK Retail,11.34,,8847.87
28/09/2015,DEB,CLKBANK*COM_RGEHNH,39.62,,8859.21
28/09/2015,DEB,Amazon Svcs Europe,2.15,,8898.83
25/09/2015,CPT,LOYD WALES UNIV SW,50,,8900.98
25/09/2015,BGC,SWANSEA UNIVERSITY,,429.29,8950.98
24/09/2015,BP,SAVE THE CHANGE,0.16,,8521.69
23/09/2015,DEB,Amazon UK Marketpl,0.84,,8521.85
22/09/2015,BP,SAVE THE CHANGE,3.73,,8522.69
21/09/2015,DEB,CYCLECHIC LTD,83.49,,8526.42
21/09/2015,DEB,AMAZON MKTPLACE PM,15.01,,8609.91
21/09/2015,DEB,Amazon UK Marketpl,8,,8624.92
21/09/2015,DEB,Amazon UK Marketpl,12.96,,8632.92
21/09/2015,DEB,Amazon Svcs Europe,39.11,,8645.88
21/09/2015,DEB,Amazon UK Marketpl,3.11,,8684.99
21/09/2015,DEB,Amazon UK Marketpl,1.59,,8688.1
21/09/2015,DD,VIRGIN MEDIA PYMTS,35.45,,8689.69
21/09/2015,BP,SAVE THE CHANGE,0.51,,8725.14
18/09/2015,DEB,Amazon UK Retail,5.49,,8725.65
16/09/2015,DEB,IBIS BRISTOL TEMPL,110,,8731.14
16/09/2015,DD,O2,17.41,,8841.14
09/09/2015,DD,LV LIFE,37.12,,8858.55
07/09/2015,DEB,LIFELOADED LTD,,62.83,8895.67
07/09/2015,BP,SAVE THE CHANGE,0.45,,8832.84
04/09/2015,DEB,JS ONLINE GROCERY,152.56,,8833.29
04/09/2015,DEB,Amazon UK Retail,5.99,,8985.85
04/09/2015,DEB,FGW WEBSALES,94,,8991.84
04/09/2015,BP,SAVE THE CHANGE,0.01,,9085.84
03/09/2015,DEB,Amazon UK Marketpl,14.99,,9085.85
03/09/2015,CHQ,41,375,,9100.84
03/09/2015,DD,ASSURANT INTER LTD,35.59,,9475.84
03/09/2015,BP,SAVE THE CHANGE,2.31,,9511.43
02/09/2015,DEB,Amazon UK Marketpl,38.48,,9513.74
02/09/2015,DEB,Amazon UK Retail,20.17,,9552.22
02/09/2015,DEB,Amazon UK Marketpl,6.53,,9572.39
02/09/2015,DEB,NON-STG PURCH FEE,1,,9578.92
02/09/2015,DEB,NON-STG TRANS FEE,1.86,,9579.92
02/09/2015,DEB,LIFELOADED LTD,62.51,,9581.78
02/09/2015,BP,SAVE THE CHANGE,0.53,,9644.29
01/09/2015,FEE,ACCOUNT FEE,9.95,,9644.82
01/09/2015,,INTEREST (NET),,4.74,9654.77
01/09/2015,DEB,EASYJET   000EPK,497.96,,9650.03
01/09/2015,DEB,Amazon UK Marketpl,5.51,,10147.99
01/09/2015,DD,NATWEST BANK,748.13,,10153.5
01/09/2015,DD,CC SWANSEA C.TAX,122,,10901.63
01/09/2015,DD,GOOD ENERGY GAS,43,,11023.63
01/09/2015,DD,DWR CYMRU W WATER,14.5,,11066.63
01/09/2015,DD,GOOD ENERGY LTD,13,,11081.13
01/09/2015,DD,TV LICENCE MBP,12.12,,11094.13
01/09/2015,SO,ESAVINGS ACCOUNT,300,,11106.25
01/09/2015,BP,SAVE THE CHANGE,1.61,,11406.25
28/08/2015,DEB,Amazon UK Marketpl,12.42,,11407.86
28/08/2015,DEB,Amazon UK Retail,11.2,,11420.28
28/08/2015,DEB,Amazon Svcs Europe,2.77,,11431.48
28/08/2015,CPT,LOYD WALES UNIV SW,30,,11434.25
28/08/2015,DD,UNIV & COL UNION,22.37,,11464.25
28/08/2015,BP,SAVE THE CHANGE,0.06,,11486.62
28/08/2015,BGC,SWANSEA UNIVERSITY,,3043.03,11486.68
27/08/2015,DEB,Amazon UK Marketpl,16.99,,8443.65
27/08/2015,DEB,Amazon Svcs Europe,2.95,,8460.64
26/08/2015,CPT,LOYD WALES UNIV SW,30,,8463.59
26/08/2015,BP,SAVE THE CHANGE,0.44,,8493.59
25/08/2015,DEB,Amazon UK Marketpl,1.56,,8494.03
25/08/2015,BP,SAVE THE CHANGE,0.4,,8495.59
24/08/2015,DEB,ARRIVA TRAINS WALE,17.6,,8495.99
24/08/2015,CPT,LOYD SWANSEA UNIVE,70,,8513.59
24/08/2015,BP,SAVE THE CHANGE,1.15,,8583.59
24/08/2015,FPO,ALAN HOLLAND,140,,8584.74
21/08/2015,DEB,BIG SLEEP HOTEL,45,,8724.74
21/08/2015,DEB,ARRIVA TRAINS WALE,17.6,,8769.74
21/08/2015,DEB,Amazon Svcs Europe,5.25,,8787.34
21/08/2015,DD,VIRGIN MEDIA PYMTS,27.78,,8792.59
21/08/2015,BP,SAVE THE CHANGE,0.52,,8820.37
20/08/2015,DEB,Amazon UK Marketpl,7.99,,8820.89
20/08/2015,DEB,Amazon UK Retail,3.49,,8828.88
20/08/2015,BP,SAVE THE CHANGE,0.8,,8832.37
19/08/2015,DEB,Amazon UK Marketpl,9.2,,8833.17
19/08/2015,BP,SAVE THE CHANGE,0.78,,8842.37
18/08/2015,DEB,Amazon UK Marketpl,13.25,,8843.15
18/08/2015,DEB,Amazon UK Marketpl,8.98,,8856.4
18/08/2015,DEB,Amazon Svcs Europe,5.99,,8865.38
18/08/2015,BP,SAVE THE CHANGE,2.37,,8871.37
17/08/2015,DEB,ISTANBUL RESTAURAN,56.3,,8873.74
17/08/2015,DEB,Amazon UK Retail,3,,8930.04
17/08/2015,DEB,Amazon UK Marketpl,4.05,,8933.04
17/08/2015,DEB,Amazon UK Marketpl,4.64,,8937.09
17/08/2015,DEB,NON-STG PURCH FEE,1,,8941.73
17/08/2015,DEB,NON-STG TRANS FEE,0.01,,8942.73
17/08/2015,DEB,LIFELOADED LTD,0.64,,8942.74
17/08/2015,DD,O2,18.61,,8943.38
17/08/2015,BP,SAVE THE CHANGE,0.05,,8961.99
14/08/2015,DEB,THE BAYVIEW PUB AN,26.95,,8962.04
14/08/2015,CPT,LOYD WALES UNIV SW,20,,8988.99
13/08/2015,CPT,LOYD SWANSEA UNIVE,50,,9008.99
13/08/2015,BP,SAVE THE CHANGE,0.41,,9058.99
12/08/2015,DEB,Amazon UK Marketpl,1.59,,9059.4
12/08/2015,BP,SAVE THE CHANGE,0.85,,9060.99
11/08/2015,DEB,HILTON,29.15,,9061.84
11/08/2015,DEB,HILTON,238,,9090.99
11/08/2015,BP,SAVE THE CHANGE,2.88,,9328.99
10/08/2015,DEB,ARRIVA TRAINS WALE,70.5,,9331.87
10/08/2015,DEB,Amazon UK Retail,14.95,,9402.37
10/08/2015,DEB,M&S SIMPLY FOOD -,13.41,,9417.32
10/08/2015,DEB,Amazon UK Marketpl,4.08,,9430.73
10/08/2015,DEB,Amazon UK Retail,7,,9434.81
10/08/2015,DEB,Amazon Svcs Europe,22.18,,9441.81
10/08/2015,DD,LV LIFE,37.12,,9463.99
07/08/2015,CPT,LOYD SWANSEA UNIVE,60,,9501.11
07/08/2015,BP,SAVE THE CHANGE,0.62,,9561.11
06/08/2015,DEB,Amazon UK Retail,20.98,,9561.73
06/08/2015,DEB,Amazon UK Retail,18.94,,9582.71
06/08/2015,DEB,EXOTICA,15.46,,9601.65
06/08/2015,BP,SAVE THE CHANGE,0.98,,9617.11
05/08/2015,DEB,EXOTICA,21,,9618.09
05/08/2015,DEB,Amazon UK Marketpl,5.99,,9639.09
05/08/2015,DEB,Amazon UK Marketpl,5.15,,9645.08
05/08/2015,DEB,Amazon UK Marketpl,1.88,,9650.23
05/08/2015,BP,SAVE THE CHANGE,1.07,,9652.11
04/08/2015,DEB,Amazon UK Retail,7.13,,9653.18
04/08/2015,DEB,Amazon UK Marketpl,2.8,,9660.31
04/08/2015,BP,SAVE THE CHANGE,0.01,,9663.11
03/08/2015,FEE,ACCOUNT FEE,9.95,,9663.12
03/08/2015,,INTEREST (NET),,5.4,9673.07
03/08/2015,DEB,Amazon Svcs Europe,89.99,,9667.67
03/08/2015,CPT,LOYD WALES UNIV SW,50,,9757.66
03/08/2015,DD,NATWEST BANK,748.13,,9807.66
03/08/2015,DD,CC SWANSEA C.TAX,122,,10555.79
03/08/2015,DD,GOOD ENERGY GAS,71,,10677.79
03/08/2015,DD,GOOD ENERGY LTD,43,,10748.79
03/08/2015,DD,ASSURANT INTER LTD,35.56,,10791.79
03/08/2015,DD,DWR CYMRU W WATER,22.5,,10827.35
03/08/2015,DD,TV LICENCE MBP,12.12,,10849.85
03/08/2015,SO,ESAVINGS ACCOUNT,300,,10861.97
03/08/2015,BP,SAVE THE CHANGE,0.5,,11161.97
03/08/2015,BGC,STFC AP,,585.29,11162.47
31/07/2015,DEB,ARRIVA TRAINS WALE,33.5,,10577.18
31/07/2015,DD,UNIV & COL UNION,22.37,,10610.68
31/07/2015,BP,SAVE THE CHANGE,0.2,,10633.05
31/07/2015,BGC,SWANSEA UNIVERSITY,,3042.63,10633.25
31/07/2015,BGC,SWANSEA UNIVERSITY,,503.36,7590.62
30/07/2015,DEB,Amazon UK Marketpl,6.8,,7087.26
30/07/2015,BP,SAVE THE CHANGE,0.52,,7094.06
29/07/2015,DEB,Amazon UK Marketpl,17.94,,7094.58
29/07/2015,DEB,Amazon Svcs Europe,4.54,,7112.52
29/07/2015,CPT,LOYD SWANSEA UNIVE,70,,7117.06
29/07/2015,BP,SAVE THE CHANGE,0.51,,7187.06
28/07/2015,DEB,Amazon Svcs Europe,5.49,,7187.57
28/07/2015,BP,SAVE THE CHANGE,1.1,,7193.06
27/07/2015,DEB,Amazon UK Marketpl,6.39,,7194.16
27/07/2015,DEB,JS ONLINE GROCERY,316.51,,7200.55
27/07/2015,FPO,ALAN HOLLAND,1000,,7517.06
